,date,area,area_type,population,cases,cumulative_cases,deaths,cumulative_deaths,total_tests,cumulative_total_tests,positive_tests,cumulative_positive_tests,reported_cases,cumulative_reported_cases,reported_deaths,cumulative_reported_deaths,reported_tests
4960,2/1/2020,California,State,40129160,24,24,0,0,304,304,9,9,3,3,0,0,
4961,2/2/2020,California,State,40129160,9,33,0,0,36,340,2,11,3,6,0,0,
4962,2/3/2020,California,State,40129160,7,40,0,0,29,369,1,12,0,6,0,0,
4963,2/4/2020,California,State,40129160,1,41,0,0,32,401,1,13,0,6,0,0,
4964,2/5/2020,California,State,40129160,3,44,0,0,45,446,1,14,0,6,0,0,
4965,2/6/2020,California,State,40129160,6,50,1,1,12,458,1,15,0,6,0,0,
4966,2/7/2020,California,State,40129160,32,82,0,1,453,911,62,77,0,6,0,0,
4967,2/8/2020,California,State,40129160,7,89,0,1,59,970,2,79,0,6,0,0,
4968,2/9/2020,California,State,40129160,5,94,0,1,21,991,1,80,0,6,0,0,
4969,2/10/2020,California,State,40129160,6,100,0,1,16,1007,1,81,0,6,0,0,
4970,2/11/2020,California,State,40129160,4,104,0,1,40,1047,0,81,1,7,0,0,
4971,2/12/2020,California,State,40129160,3,107,0,1,3,1050,0,81,1,8,0,0,
4972,2/13/2020,California,State,40129160,2,109,0,1,10,1060,0,81,0,8,0,0,
4973,2/14/2020,California,State,40129160,9,118,0,1,21,1081,0,81,0,8,0,0,
4974,2/15/2020,California,State,40129160,14,132,0,1,43,1124,1,82,0,8,0,0,
4975,2/16/2020,California,State,40129160,7,139,0,1,64,1188,2,84,0,8,0,0,
4976,2/17/2020,California,State,40129160,13,152,1,2,85,1273,0,84,5,13,0,0,
4977,2/18/2020,California,State,40129160,10,162,0,2,17,1290,1,85,2,15,0,0,
4978,2/19/2020,California,State,40129160,12,174,0,2,10,1300,0,85,0,15,0,0,
4979,2/20/2020,California,State,40129160,20,194,0,2,26,1326,2,87,2,17,0,0,
4980,2/21/2020,California,State,40129160,20,214,1,3,19,1345,2,89,4,21,0,0,
4981,2/22/2020,California,State,40129160,17,231,0,3,27,1372,0,89,0,21,0,0,
4982,2/23/2020,California,State,40129160,19,250,0,3,37,1409,3,92,4,25,0,0,
4983,2/24/2020,California,State,40129160,39,289,0,3,20,1429,3,95,0,25,0,0,
4984,2/25/2020,California,State,40129160,25,314,0,3,12,1441,1,96,6,31,0,0,
4985,2/26/2020,California,State,40129160,39,353,0,3,24,1465,3,99,2,33,0,0,
4986,2/27/2020,California,State,40129160,26,379,0,3,78,1543,9,108,0,33,0,0,
4987,2/28/2020,California,State,40129160,49,428,0,3,121,1664,17,125,1,34,0,0,
4988,2/29/2020,California,State,40129160,41,469,0,3,89,1753,16,141,0,34,0,0,
4989,3/1/2020,California,State,40129160,100,569,0,3,79,1832,4,145,5,39,0,0,
4990,3/2/2020,California,State,40129160,76,645,0,3,177,2009,33,178,4,43,0,0,
4991,3/3/2020,California,State,40129160,85,730,0,3,142,2151,25,203,10,53,0,0,
4992,3/4/2020,California,State,40129160,95,825,1,4,237,2388,39,242,7,60,1,1,
4993,3/5/2020,California,State,40129160,111,936,0,4,367,2755,36,278,9,69,0,1,
4994,3/6/2020,California,State,40129160,159,1095,1,5,411,3166,31,309,19,88,0,1,
4995,3/7/2020,California,State,40129160,164,1259,0,5,506,3672,76,385,26,114,0,1,
4996,3/8/2020,California,State,40129160,181,1440,0,5,321,3993,51,436,19,133,0,1,
4997,3/9/2020,California,State,40129160,332,1772,3,8,1028,5021,130,566,24,157,1,2,
4998,3/10/2020,California,State,40129160,358,2130,0,8,1186,6207,124,690,20,177,1,3,
4999,3/11/2020,California,State,40129160,427,2557,1,9,1859,8066,170,860,21,198,0,3,
5000,3/12/2020,California,State,40129160,510,3067,0,9,3459,11525,238,1098,49,247,1,4,
5001,3/13/2020,California,State,40129160,583,3650,1,10,4467,15992,332,1430,41,288,-1,3,
5002,3/14/2020,California,State,40129160,513,4163,1,11,2782,18774,312,1742,47,335,1,4,
5003,3/15/2020,California,State,40129160,602,4765,2,13,2765,21539,255,1997,57,392,1,5,
5004,3/16/2020,California,State,40129160,882,5647,5,18,7762,29301,579,2576,80,472,0,5,
5005,3/17/2020,California,State,40129160,837,6484,6,24,8942,38243,653,3229,38,510,2,7,
5006,3/18/2020,California,State,40129160,779,7263,0,24,8925,47168,616,3845,165,675,8,15,
5007,3/19/2020,California,State,40129160,787,8050,7,31,9026,56194,663,4508,331,1006,3,18,
5008,3/20/2020,California,State,40129160,965,9015,7,38,10034,66228,769,5277,218,1224,6,24,
5009,3/21/2020,California,State,40129160,692,9707,10,48,5084,71312,478,5755,244,1468,2,26,
5010,3/22/2020,California,State,40129160,763,10470,14,62,4641,75953,608,6363,265,1733,9,35,
5011,3/23/2020,California,State,40129160,1041,11511,17,79,12580,88533,1212,7575,222,1955,2,37,
5012,3/24/2020,California,State,40129160,849,12360,18,97,11936,100469,1205,8780,580,2535,11,48,
5013,3/25/2020,California,State,40129160,1044,13404,20,117,11725,112194,1207,9987,471,3006,16,64,
5014,3/26/2020,California,State,40129160,972,14376,15,132,11779,123973,1184,11171,795,3801,14,78,
5015,3/27/2020,California,State,40129160,1003,15379,22,154,12570,136543,1317,12488,842,4643,23,101,
5016,3/28/2020,California,State,40129160,934,16313,26,180,7997,144540,1037,13525,5923,10566,134,235,
5017,3/29/2020,California,State,40129160,824,17137,25,205,5241,149781,698,14223,-4803,5763,-100,135,
5018,3/30/2020,California,State,40129160,1380,18517,27,232,13957,163738,1610,15833,1169,6932,15,150,
5019,3/31/2020,California,State,40129160,1261,19778,41,273,13743,177481,1554,17387,1223,8155,21,171,
5020,4/1/2020,California,State,40129160,1503,21281,41,314,14972,192453,1762,19149,1036,9191,32,203,
5021,4/2/2020,California,State,40129160,1371,22652,54,368,15105,207558,1695,20844,1510,10701,34,237,
5022,4/3/2020,California,State,40129160,1516,24168,52,420,15305,222863,1536,22380,1325,12026,39,276,
5023,4/4/2020,California,State,40129160,1125,25293,38,458,8010,230873,1078,23458,1412,13438,43,319,
5024,4/5/2020,California,State,40129160,1140,26433,57,515,6073,236946,985,24443,898,14336,24,343,
5025,4/6/2020,California,State,40129160,1360,27793,36,551,13684,250630,1543,25986,1529,15865,31,374,
5026,4/7/2020,California,State,40129160,1422,29215,62,613,15231,265861,1774,27760,1092,16957,69,443,
5027,4/8/2020,California,State,40129160,1472,30687,63,676,15978,281839,1774,29534,1352,18309,49,492,
5028,4/9/2020,California,State,40129160,1404,32091,58,734,17869,299708,1761,31295,1163,19472,49,541,
5029,4/10/2020,California,State,40129160,1473,33564,60,794,18147,317855,1699,32994,1143,20615,40,581,
5030,4/11/2020,California,State,40129160,1051,34615,53,847,9202,327057,1072,34066,1179,21794,39,620,
5031,4/12/2020,California,State,40129160,999,35614,67,914,5748,332805,736,34802,554,22348,38,658,
5032,4/13/2020,California,State,40129160,1522,37136,78,992,15316,348121,1914,36716,905,23253,34,692,
5033,4/14/2020,California,State,40129160,1495,38631,88,1080,16717,364838,1756,38472,1171,24424,96,788,
5034,4/15/2020,California,State,40129160,1665,40296,67,1147,19900,384738,1982,40454,1758,26182,82,870,
5035,4/16/2020,California,State,40129160,1676,41972,97,1244,19677,404415,1878,42332,1346,27528,80,950,
5036,4/17/2020,California,State,40129160,1609,43581,72,1316,20731,425146,1741,44073,1435,28963,74,1024,
5037,4/18/2020,California,State,40129160,1206,44787,68,1384,12984,438130,1273,45346,1370,30333,93,1117,
5038,4/19/2020,California,State,40129160,1081,45868,66,1450,8665,446795,901,46247,645,30978,30,1147,
5039,4/20/2020,California,State,40129160,1919,47787,86,1536,22152,468947,2179,48426,2283,33261,41,1188,
5040,4/21/2020,California,State,40129160,1673,49460,72,1608,25254,494201,2029,50455,2135,35396,105,1293,
5041,4/22/2020,California,State,40129160,1764,51224,83,1691,24099,518300,2026,52481,1973,37369,103,1396,
5042,4/23/2020,California,State,40129160,1838,53062,88,1779,25486,543786,2142,54623,1885,39254,93,1489,
5043,4/24/2020,California,State,40129160,2009,55071,77,1856,29678,573464,2328,56951,1883,41137,84,1573,
5044,4/25/2020,California,State,40129160,1617,56688,66,1922,19948,593412,1711,58662,1027,42164,74,1647,
5045,4/26/2020,California,State,40129160,1267,57955,69,1991,11505,604917,1014,59676,1300,43464,29,1676,
5046,4/27/2020,California,State,40129160,2253,60208,67,2058,34819,639736,2747,62423,1567,45031,45,1721,
5047,4/28/2020,California,State,40129160,2102,62310,92,2150,35608,675344,2554,64977,1469,46500,88,1809,
5048,4/29/2020,California,State,40129160,2034,64344,76,2226,35910,711254,2406,67383,2417,48917,81,1890,
5049,4/30/2020,California,State,40129160,1939,66283,77,2303,40965,752219,2359,69742,1525,50442,98,1988,
5050,5/1/2020,California,State,40129160,2232,68515,70,2373,45056,797275,2361,72103,1755,52197,95,2083,
5051,5/2/2020,California,State,40129160,1388,69903,98,2471,26642,823917,1380,73483,1419,53616,55,2138,
5052,5/3/2020,California,State,40129160,1150,71053,70,2541,15583,839500,1050,74533,1321,54937,40,2178,
5053,5/4/2020,California,State,40129160,2424,73477,75,2616,45277,884777,2708,77241,1275,56212,43,2221,
5054,5/5/2020,California,State,40129160,2594,76071,67,2683,48223,933000,2971,80212,2603,58815,104,2325,29104
5055,5/6/2020,California,State,40129160,2347,78418,97,2780,56358,989358,2904,83116,1799,60614,87,2412,33814
5056,5/7/2020,California,State,40129160,2146,80564,83,2863,53502,1042860,2558,85674,1898,62512,81,2493,32367
5057,5/8/2020,California,State,40129160,2266,82830,83,2946,53258,1096118,2583,88257,2049,64561,83,2576,37270
5058,5/9/2020,California,State,40129160,1584,84414,87,3033,27466,1123584,1578,89835,2119,66680,81,2657,43063
5059,5/10/2020,California,State,40129160,1326,85740,73,3106,14870,1138454,923,90758,1259,67939,34,2691,36203
5060,5/11/2020,California,State,40129160,2442,88182,67,3173,51512,1189966,2770,93528,1443,69382,61,2752,41442
5061,5/12/2020,California,State,40129160,2471,90653,83,3256,59443,1249409,2962,96490,-3401,65981,-96,2656,32195
5062,5/13/2020,California,State,40129160,2306,92959,73,3329,57187,1306596,2927,99417,7183,73164,270,2926,39033
5063,5/14/2020,California,State,40129160,2658,95617,73,3402,57962,1364558,3417,102834,1772,74936,103,3029,29229
5064,5/15/2020,California,State,40129160,2517,98134,75,3477,62969,1427527,3396,106230,1857,76793,90,3119,45190
5065,5/16/2020,California,State,40129160,1733,99867,90,3567,34579,1462106,1866,108096,2046,78839,61,3180,56085
5066,5/17/2020,California,State,40129160,1328,101195,73,3640,17476,1479582,1119,109215,1591,80430,36,3216,57399
5067,5/18/2020,California,State,40129160,2800,103995,89,3729,64864,1544446,3714,112929,1365,81795,34,3250,46613
5068,5/19/2020,California,State,40129160,2414,106409,73,3802,66046,1610492,3511,116440,2262,84057,124,3374,40778
5069,5/20/2020,California,State,40129160,2721,109130,71,3873,64880,1675372,3736,120176,2140,86197,77,3451,40979
5070,5/21/2020,California,State,40129160,2448,111578,59,3932,63413,1738785,3465,123641,2247,88444,93,3544,45645
5071,5/22/2020,California,State,40129160,2524,114102,79,4011,67662,1806447,3308,126949,2187,90631,45,3589,48533
5072,5/23/2020,California,State,40129160,1749,115851,71,4082,36515,1842962,1951,128900,2079,92710,57,3646,67439
5073,5/24/2020,California,State,40129160,1404,117255,76,4158,19729,1862691,1188,130088,1848,94558,20,3666,61357
5074,5/25/2020,California,State,40129160,2229,119484,58,4216,18629,1881320,1451,131539,2175,96733,13,3679,52294
5075,5/26/2020,California,State,40129160,3594,123078,80,4296,77824,1959144,5128,136667,2247,98980,28,3707,40498
5076,5/27/2020,California,State,40129160,3522,126600,81,4377,74038,2033182,4486,141153,2717,101697,109,3816,53665
5077,5/28/2020,California,State,40129160,3180,129780,70,4447,69933,2103115,4032,145185,2189,103886,88,3904,44919
5078,5/29/2020,California,State,40129160,3784,133564,61,4508,76908,2180023,4574,149759,2992,106878,81,3985,53117
5079,5/30/2020,California,State,40129160,2223,135787,66,4574,40971,2220994,2359,152118,3705,110583,58,4043,56253
5080,5/31/2020,California,State,40129160,1586,137373,67,4641,21385,2242379,1246,153364,2423,113006,37,4080,67735
5081,6/1/2020,California,State,40129160,3670,141043,78,4719,67661,2310040,3777,157141,2304,115310,47,4127,59008
5082,6/2/2020,California,State,40129160,3905,144948,65,4784,71821,2381861,4471,161612,2377,117687,104,4231,59703
5083,6/3/2020,California,State,40129160,3413,148361,84,4868,70612,2452473,4077,165689,2120,119807,67,4298,51377
5084,6/4/2020,California,State,40129160,3592,151953,74,4942,74097,2526570,4169,169858,3094,122901,70,4368,55792
5085,6/5/2020,California,State,40129160,3705,155658,64,5006,81882,2608452,4251,174109,3115,126016,67,4435,69837
5086,6/6/2020,California,State,40129160,2702,158360,64,5070,46383,2654835,2755,176864,2796,128812,66,4501,53918
5087,6/7/2020,California,State,40129160,2031,160391,67,5137,24238,2679073,1433,178297,2507,131319,27,4528,68972
5088,6/8/2020,California,State,40129160,4202,164593,80,5217,85794,2764867,4729,183026,2170,133489,31,4559,55055
5089,6/9/2020,California,State,40129160,3994,168587,76,5293,91079,2855946,4962,187988,2702,136191,104,4663,54553
5090,6/10/2020,California,State,40129160,4254,172841,62,5355,89316,2945262,5253,193241,3090,139281,106,4769,56849
5091,6/11/2020,California,State,40129160,4064,176905,60,5415,89648,3034910,5150,198391,2702,141983,63,4832,64611
5092,6/12/2020,California,State,40129160,4471,181376,69,5484,91417,3126327,5036,203427,3660,145643,47,4879,62135
5093,6/13/2020,California,State,40129160,3648,185024,72,5556,45229,3171556,3290,206717,3212,148855,82,4961,77603
5094,6/14/2020,California,State,40129160,2999,188023,65,5621,26222,3197778,1863,208580,2597,151452,19,4980,66186
5095,6/15/2020,California,State,40129160,6432,194455,68,5689,94480,3292258,6457,215037,2108,153560,22,5002,69573
5096,6/16/2020,California,State,40129160,6463,200918,59,5748,99627,3391885,7418,222455,3455,157015,62,5064,60233
5097,6/17/2020,California,State,40129160,6750,207668,69,5817,99565,3491450,7759,230214,4084,161099,78,5142,76542
5098,6/18/2020,California,State,40129160,6757,214425,67,5884,101105,3592555,8051,238265,4317,165416,108,5250,81172
5099,6/19/2020,California,State,40129160,6916,221341,81,5965,101233,3693788,8055,246320,3893,169309,68,5318,78710
5100,6/20/2020,California,State,40129160,5356,226697,78,6043,50681,3744469,5064,251384,4515,173824,84,5402,84844
5101,6/21/2020,California,State,40129160,4353,231050,72,6115,27844,3772313,2967,254351,4230,178054,23,5425,92430
5102,6/22/2020,California,State,40129160,9404,240454,72,6187,108236,3880549,9696,264047,5019,183073,20,5445,85243
5103,6/23/2020,California,State,40129160,9700,250154,67,6254,121129,4001678,10794,274841,7149,190222,54,5499,95970
5104,6/24/2020,California,State,40129160,9858,260012,93,6347,123629,4125307,11025,285866,5349,195571,104,5603,101446
5105,6/25/2020,California,State,40129160,9426,269438,70,6417,128549,4253856,11269,297135,4890,200461,114,5717,76969
5106,6/26/2020,California,State,40129160,9113,278551,83,6500,125033,4378889,10514,307649,5972,206433,69,5786,90996
5107,6/27/2020,California,State,40129160,6269,284820,65,6565,64489,4443378,6526,314175,3979,210412,25,5811,93642
5108,6/28/2020,California,State,40129160,5470,290290,95,6660,37007,4480385,3981,318156,6138,216550,39,5850,105740
5109,6/29/2020,California,State,40129160,10514,300804,96,6756,123327,4603712,11803,329959,6367,222917,27,5877,105447
5110,6/30/2020,California,State,40129160,10523,311327,96,6852,132324,4736036,12313,342272,9740,232657,101,5978,87037
5111,7/1/2020,California,State,40129160,11244,322571,86,6938,137044,4873080,12471,354743,7538,240195,81,6059,84542
5112,7/2/2020,California,State,40129160,10626,333197,108,7046,146189,5019269,12811,367554,8040,248235,125,6184,109458
5113,7/3/2020,California,State,40129160,7982,341179,92,7138,81385,5100654,8049,375603,6510,254745,63,6247,104855
5114,7/4/2020,California,State,40129160,5384,346563,86,7224,27401,5128055,3752,379355,5410,260155,18,6265,127107
5115,7/5/2020,California,State,40129160,6229,352792,96,7320,39347,5167402,4668,384023,11529,271684,36,6301,113215
5116,7/6/2020,California,State,40129160,11787,364579,118,7438,137958,5305360,13030,397053,6090,277774,61,6362,103017
5117,7/7/2020,California,State,40129160,12529,377108,102,7540,155627,5460987,14870,411923,11694,289468,113,6475,99805
5118,7/8/2020,California,State,40129160,12201,389309,107,7647,159795,5620782,14763,426686,7031,296499,146,6621,82259
5119,7/9/2020,California,State,40129160,11170,400479,94,7741,155300,5776082,14319,441005,7798,304297,166,6787,97303
5120,7/10/2020,California,State,40129160,11424,411903,113,7854,152288,5928370,13955,454960,8047,312344,105,6892,99958
5121,7/11/2020,California,State,40129160,7571,419474,115,7969,79872,6008242,8512,463472,8460,320804,97,6989,130904
5122,7/12/2020,California,State,40129160,5895,425369,108,8077,44532,6052774,5166,468638,8358,329162,25,7014,137766
5123,7/13/2020,California,State,40129160,11648,437017,144,8221,157002,6209776,14073,482711,7285,336447,25,7039,130590
5124,7/14/2020,California,State,40129160,11563,448580,132,8353,162693,6372469,14652,497363,11187,347634,125,7164,118321
5125,7/15/2020,California,State,40129160,11601,460181,134,8487,162897,6535366,14109,511472,8544,356178,119,7283,122232
5126,7/16/2020,California,State,40129160,11069,471250,129,8616,161475,6696841,13831,525303,9986,366164,126,7409,128591
5127,7/17/2020,California,State,40129160,10693,481943,123,8739,150121,6846962,13304,538607,9199,375363,121,7530,123119
5128,7/18/2020,California,State,40129160,7330,489273,129,8868,81980,6928942,8196,546803,9329,384692,90,7620,119634
5129,7/19/2020,California,State,40129160,5485,494758,127,8995,50622,6979564,5006,551809,6846,391538,31,7651,127686
5130,7/20/2020,California,State,40129160,11065,505823,147,9142,160336,7139900,13733,565542,9231,400769,26,7677,122973
5131,7/21/2020,California,State,40129160,10109,515932,139,9281,165354,7305254,13524,579066,12807,413576,116,7793,127487
5132,7/22/2020,California,State,40129160,9369,525301,144,9425,151060,7456314,11654,590720,12040,425616,156,7949,113306
5133,7/23/2020,California,State,40129160,8501,533802,139,9564,137650,7593964,10664,601384,9212,434828,147,8096,137572
5134,7/24/2020,California,State,40129160,8285,542087,139,9703,121500,7715464,10318,611702,10572,445400,146,8242,131479
5135,7/25/2020,California,State,40129160,5799,547886,175,9878,66798,7782262,6502,618204,8259,453659,140,8382,120784
5136,7/26/2020,California,State,40129160,4153,552039,143,10021,39323,7821585,3342,621546,6891,460550,30,8412,128439
5137,7/27/2020,California,State,40129160,9087,561126,149,10170,156485,7978070,11484,633030,6000,466550,24,8436,121288
5138,7/28/2020,California,State,40129160,8799,569925,129,10299,158714,8136784,12001,645031,8755,475305,80,8516,99600
5139,7/29/2020,California,State,40129160,7812,577737,157,10456,150246,8287030,11097,656128,10197,485502,235,8751,116374
5140,7/30/2020,California,State,40129160,7239,584976,147,10603,142127,8429157,10277,666405,8086,493588,188,8939,177201
5141,7/31/2020,California,State,40129160,7215,592191,148,10751,138857,8568014,10052,676457,6542,500130,156,9095,75546
5142,8/1/2020,California,State,40129160,5387,597578,137,10888,73123,8641137,5931,682388,9032,509162,157,9252,149388
5143,8/2/2020,California,State,40129160,3572,601150,136,11024,40655,8681792,3140,685528,5739,514901,74,9326,148721
5144,8/3/2020,California,State,40129160,7557,608707,178,11202,144711,8826503,10204,695732,4526,519427,23,9349,121017
5145,8/4/2020,California,State,40129160,7226,615933,161,11363,156506,8983009,10326,706058,5295,524722,171,9520,103687
5146,8/5/2020,California,State,40129160,6704,622637,149,11512,145224,9128233,8754,714812,5258,529980,140,9660,91063
5147,8/6/2020,California,State,40129160,6258,628895,118,11630,135958,9264191,8499,723311,8436,538416,147,9807,96419
5148,8/7/2020,California,State,40129160,6447,635342,135,11765,128438,9392629,8721,732032,7371,545787,175,9982,110645
5149,8/8/2020,California,State,40129160,4294,639636,133,11898,62196,9454825,4666,736698,8373,554160,191,10173,118592
5150,8/9/2020,California,State,40129160,3178,642814,127,12025,36478,9491303,2627,739325,7751,561911,74,10247,172234
5151,8/10/2020,California,State,40129160,7088,649902,141,12166,135378,9626681,9020,748345,12500,574411,25,10272,187926
5152,8/11/2020,California,State,40129160,6208,656110,155,12321,139097,9765778,8772,757117,11645,586056,219,10491,117188
5153,8/12/2020,California,State,40129160,5960,662070,112,12433,144292,9910070,8512,765629,7085,593141,175,10666,142026
5154,8/13/2020,California,State,40129160,5156,667226,120,12553,126205,10036275,7403,773032,7934,601075,165,10831,111105
5155,8/14/2020,California,State,40129160,5212,672438,122,12675,119218,10155493,7375,780407,12614,613689,163,10994,124513
5156,8/15/2020,California,State,40129160,3665,676103,126,12801,61163,10216656,4347,784754,7873,621562,110,11104,117024
5157,8/16/2020,California,State,40129160,2684,678787,131,12932,33809,10250465,2181,786935,6469,628031,10,11114,135645
5158,8/17/2020,California,State,40129160,5772,684559,117,13049,129290,10379755,7460,794395,4636,632667,31,11145,115259
5159,8/18/2020,California,State,40129160,5266,689825,121,13170,128585,10508340,6967,801362,6164,638831,156,11301,91644
5160,8/19/2020,California,State,40129160,4678,694503,137,13307,128315,10636655,6541,807903,5920,644751,165,11466,87283
5161,8/20/2020,California,State,40129160,4671,699174,108,13415,113808,10750463,6245,814148,5585,650336,124,11590,101406
5162,8/21/2020,California,State,40129160,4404,703578,119,13534,112758,10863221,6522,820670,6556,656892,151,11741,106980
5163,8/22/2020,California,State,40129160,3115,706693,120,13654,57038,10920259,3710,824380,6777,663669,204,11945,104679
5164,8/23/2020,California,State,40129160,2569,709262,106,13760,33380,10953639,2249,826629,4946,668615,10,11955,111456
5165,8/24/2020,California,State,40129160,5459,714721,108,13868,125133,11078772,6751,833380,4480,673095,48,12003,110019
5166,8/25/2020,California,State,40129160,4915,719636,108,13976,127508,11206280,6742,840122,6004,679099,155,12158,70251
5167,8/26/2020,California,State,40129160,4607,724243,98,14074,131094,11337374,6303,846425,4430,683529,138,12296,85658
5168,8/27/2020,California,State,40129160,3982,728225,117,14191,112082,11449456,5602,852027,5329,688858,165,12461,92222
5169,8/28/2020,California,State,40129160,3937,732162,86,14277,109369,11558825,5472,857499,4981,693839,108,12569,98993
5170,8/29/2020,California,State,40129160,2627,734789,118,14395,56755,11615580,3284,860783,6070,699909,176,12745,122199
5171,8/30/2020,California,State,40129160,2254,737043,111,14506,33686,11649266,1753,862536,4176,704085,12,12757,141476
5172,8/31/2020,California,State,40129160,4343,741386,87,14593,126654,11775920,5845,868381,3712,707797,38,12795,97391
5173,9/1/2020,California,State,40129160,4595,745981,100,14693,131447,11907367,5713,874094,4255,712052,158,12953,109674
5174,9/2/2020,California,State,40129160,4043,750024,82,14775,131367,12038734,5378,879472,5125,717177,167,13120,83554
5175,9/3/2020,California,State,40129160,3676,753700,81,14856,114435,12153169,4871,884343,5106,722283,172,13292,133046
5176,9/4/2020,California,State,40129160,3456,757156,87,14943,111217,12264386,4916,889259,4956,727239,177,13469,119353
5177,9/5/2020,California,State,40129160,2266,759422,86,15029,47206,12311592,2264,891523,4905,732144,123,13592,130868
5178,9/6/2020,California,State,40129160,1979,761401,81,15110,33588,12345180,1652,893175,3091,735235,4,13596,111101
5179,9/7/2020,California,State,40129160,2337,763738,73,15183,35491,12380671,1652,894827,2676,737911,51,13647,109656
5180,9/8/2020,California,State,40129160,4255,767993,81,15264,157523,12538194,6027,900854,1616,739527,80,13727,75849
5181,9/9/2020,California,State,40129160,3615,771608,85,15349,139615,12677809,4975,905829,3338,742865,120,13847,46194
5182,9/10/2020,California,State,40129160,3227,774835,73,15422,125484,12803293,4311,910140,3326,746191,116,13963,61669
5183,9/11/2020,California,State,40129160,3372,778207,77,15499,121440,12924733,4355,914495,4107,750298,119,14082,105307
5184,9/12/2020,California,State,40129160,2345,780552,75,15574,56351,12981084,2499,916994,4625,754923,128,14210,133049
5185,9/13/2020,California,State,40129160,2041,782593,70,15644,34016,13015100,1352,918346,2855,757778,1,14211,116173
5186,9/14/2020,California,State,40129160,4180,786773,78,15722,132951,13148051,5095,923441,2235,760013,49,14260,121981
5187,9/15/2020,California,State,40129160,3760,790533,85,15807,144912,13292963,4768,928209,2950,762963,151,14411,72352
5188,9/16/2020,California,State,40129160,3802,794335,62,15869,136614,13429577,4707,932916,3238,766201,106,14517,79515
5189,9/17/2020,California,State,40129160,3305,797640,73,15942,129467,13559044,4459,937375,3630,769831,110,14627,97149
5190,9/18/2020,California,State,40129160,3452,801092,57,15999,124218,13683262,4497,941872,4304,774135,135,14762,166700
5191,9/19/2020,California,State,40129160,2484,803576,72,16071,59956,13743218,2661,944533,4265,778400,86,14848,179272
5192,9/20/2020,California,State,40129160,2165,805741,71,16142,36827,13780045,1658,946191,3294,781694,25,14873,149624
5193,9/21/2020,California,State,40129160,4087,809828,57,16199,144883,13924928,4971,951162,2630,784324,27,14900,131273
5194,9/22/2020,California,State,40129160,3702,813530,68,16267,152819,14077747,4686,955848,3146,787470,138,15038,75368
5195,9/23/2020,California,State,40129160,3770,817300,66,16333,148442,14226189,4734,960582,3170,790640,116,15154,73434
5196,9/24/2020,California,State,40129160,3349,820649,71,16404,134346,14360535,4508,965090,3400,794040,102,15256,99390
5197,9/25/2020,California,State,40129160,3493,824142,56,16460,125079,14485614,4621,969711,4197,798237,105,15361,130483
5198,9/26/2020,California,State,40129160,2364,826506,74,16534,63073,14548687,2560,972271,4071,802308,71,15432,150768
5199,9/27/2020,California,State,40129160,2071,828577,58,16592,41782,14590469,1641,973912,2955,805263,19,15451,151354
5200,9/28/2020,California,State,40129160,4067,832644,55,16647,143828,14734297,4748,978660,2162,807425,11,15462,128693
5201,9/29/2020,California,State,40129160,3796,836440,54,16701,152835,14887132,4957,983617,3200,810625,195,15657,91657
5202,9/30/2020,California,State,40129160,3720,840160,40,16741,149827,15036959,4583,988200,3062,813687,100,15757,66649
5203,10/1/2020,California,State,40129160,3712,843872,58,16799,135211,15172170,4578,992778,3590,817277,161,15918,96580
5204,10/2/2020,California,State,40129160,3348,847220,58,16857,140705,15312875,4446,997224,2159,819436,14,15932,130457
5205,10/3/2020,California,State,40129160,2668,849888,49,16906,71491,15384366,2724,999948,4293,823729,67,15999,161399
5206,10/4/2020,California,State,40129160,2225,852113,69,16975,44573,15428939,1583,1001531,3055,826784,21,16020,141394
5207,10/5/2020,California,State,40129160,4304,856417,56,17031,171508,15600447,5128,1006659,1677,828461,26,16046,128740
5208,10/6/2020,California,State,40129160,3737,860154,50,17081,180584,15781031,4720,1011379,2764,831225,85,16131,126285
5209,10/7/2020,California,State,40129160,3723,863877,56,17137,171646,15952677,4694,1016073,3575,834800,94,16225,66917
5210,10/8/2020,California,State,40129160,3771,867648,55,17192,159451,16112128,4886,1020959,3806,838606,73,16298,112874
5211,10/9/2020,California,State,40129160,3555,871203,49,17241,149732,16261860,4626,1025585,4170,842776,82,16380,141948
5212,10/10/2020,California,State,40129160,3011,874214,50,17291,69884,16331744,3034,1028619,3803,846579,80,16460,168559
5213,10/11/2020,California,State,40129160,2222,876436,47,17338,44997,16376741,1627,1030246,3449,850028,10,16470,144337
5214,10/12/2020,California,State,40129160,4330,880766,42,17380,166338,16543079,5176,1035422,2378,852406,10,16480,142376
5215,10/13/2020,California,State,40129160,3853,884619,49,17429,181549,16724628,4879,1040301,2666,855072,42,16522,91770
5216,10/14/2020,California,State,40129160,3822,888441,46,17475,174002,16898630,4748,1045049,3329,858401,99,16621,92325
5217,10/15/2020,California,State,40129160,3912,892353,41,17516,159766,17058396,4935,1049984,3075,861476,91,16712,104144
5218,10/16/2020,California,State,40129160,3816,896169,42,17558,153554,17211950,4879,1054863,2979,864455,78,16790,134755
5219,10/17/2020,California,State,40129160,2959,899128,35,17593,72182,17284132,3240,1058103,2862,867317,93,16883,135351
5220,10/18/2020,California,State,40129160,2548,901676,35,17628,47318,17331450,1940,1060043,3474,870791,11,16894,150346
5221,10/19/2020,California,State,40129160,5029,906705,55,17683,186770,17518220,6107,1066150,3286,874077,14,16908,146662
5222,10/20/2020,California,State,40129160,4657,911362,43,17726,188578,17706798,5614,1071764,3707,877784,79,16987,104069
5223,10/21/2020,California,State,40129160,4425,915787,42,17768,177613,17884411,5270,1077034,2940,880724,136,17123,65631
5224,10/22/2020,California,State,40129160,4174,919961,42,17810,164147,18048558,5312,1082346,6141,886865,62,17185,124523
5225,10/23/2020,California,State,40129160,4557,924518,52,17862,153561,18202119,5668,1088014,5945,892810,46,17231,125886
5226,10/24/2020,California,State,40129160,3251,927769,48,17910,73175,18275294,3280,1091294,5219,898029,55,17286,178706
5227,10/25/2020,California,State,40129160,2904,930673,46,17956,47411,18322705,1948,1093242,2981,901010,12,17298,194944
5228,10/26/2020,California,State,40129160,5480,936153,41,17997,188206,18510911,6170,1099412,3188,904198,15,17313,144220
5229,10/27/2020,California,State,40129160,4836,940989,52,18049,192401,18703312,5566,1104978,4515,908713,116,17429,96547
5230,10/28/2020,California,State,40129160,4915,945904,40,18089,185964,18889276,5368,1110346,4191,912904,73,17502,100175
5231,10/29/2020,California,State,40129160,4869,950773,56,18145,173741,19063017,5758,1116104,4014,916918,45,17547,120752
5232,10/30/2020,California,State,40129160,5532,956305,38,18183,161086,19224103,6236,1122340,5087,922005,58,17605,157794
5233,10/31/2020,California,State,40129160,4458,960763,50,18233,75600,19299703,4102,1126442,4529,926534,57,17662,140998
5234,11/1/2020,California,State,40129160,4979,965742,59,18292,60534,19360237,2721,1129163,4094,930628,21,17683,169186
5235,11/2/2020,California,State,40129160,8472,974214,56,18348,210431,19570668,8837,1138000,4044,934672,9,17692,162420
5236,11/3/2020,California,State,40129160,8266,982480,37,18385,208947,19779615,8614,1146614,5338,940010,79,17771,106091
5237,11/4/2020,California,State,40129160,8460,990940,49,18434,210171,19989786,9370,1155984,4566,944576,62,17833,85351
5238,11/5/2020,California,State,40129160,8147,999087,41,18475,196695,20186481,9749,1165733,6518,951094,65,17898,129986
5239,11/6/2020,California,State,40129160,8528,1007615,55,18530,189181,20375662,9683,1175416,5863,956957,46,17944,168802
5240,11/7/2020,California,State,40129160,6418,1014033,46,18576,94165,20469827,6217,1181633,9543,966500,78,18022,159477
5241,11/8/2020,California,State,40129160,5534,1019567,56,18632,66496,20536323,3535,1185168,5351,971851,-3,18019,193851
5242,11/9/2020,California,State,40129160,11109,1030676,44,18676,233592,20769915,11901,1197069,5367,977218,8,18027,176162
5243,11/10/2020,California,State,40129160,10921,1041597,59,18735,236236,21006151,11647,1208716,7464,984682,67,18094,127452
5244,11/11/2020,California,State,40129160,10624,1052221,58,18793,200107,21206258,10913,1219629,6927,991609,43,18137,119979
5245,11/12/2020,California,State,40129160,11570,1063791,74,18867,236730,21442988,13541,1233170,6893,998502,26,18163,136428
5246,11/13/2020,California,State,40129160,12471,1076262,81,18948,223884,21666872,13745,1246915,9875,1008377,74,18237,193096
5247,11/14/2020,California,State,40129160,9903,1086165,73,19021,119187,21786059,9523,1256438,10968,1019345,65,18302,195189
5248,11/15/2020,California,State,40129160,9136,1095301,80,19101,84995,21871054,6508,1262946,9890,1029235,21,18323,202109
5249,11/16/2020,California,State,40129160,17657,1112958,92,19193,277204,22148258,18673,1281619,8743,1037978,20,18343,190182
5250,11/17/2020,California,State,40129160,17126,1130084,102,19295,298896,22447154,19264,1300883,9811,1047789,52,18395,159467
5251,11/18/2020,California,State,40129160,17237,1147321,76,19371,295346,22742500,19474,1320357,11478,1059267,107,18502,133985
5252,11/19/2020,California,State,40129160,16696,1164017,111,19482,293381,23035881,19756,1340113,13005,1072272,91,18593,178023
5253,11/20/2020,California,State,40129160,17438,1181455,81,19563,280727,23316608,19563,1359676,15442,1087714,88,18681,241281
5254,11/21/2020,California,State,40129160,12335,1193790,96,19659,160890,23477498,12744,1372420,14319,1102033,73,18754,265477
5255,11/22/2020,California,State,40129160,10248,1204038,106,19765,116222,23593720,8606,1381026,8337,1110370,42,18796,220235
5256,11/23/2020,California,State,40129160,21095,1225133,101,19866,346108,23939828,22930,1403956,15329,1125699,21,18817,283819
5257,11/24/2020,California,State,40129160,20641,1245774,111,19977,328713,24268541,24097,1428053,18350,1144049,113,18930,168988
5258,11/25/2020,California,State,40129160,20760,1266534,130,20107,270708,24539249,24377,1452430,14640,1158689,101,19031,186394
5259,11/26/2020,California,State,40129160,9242,1275776,110,20217,38209,24577458,4372,1456802,12635,1171324,78,19109,219173
5260,11/27/2020,California,State,40129160,18133,1293909,120,20337,149763,24727221,17116,1473918,11996,1183320,45,19154,257264
5261,11/28/2020,California,State,40129160,18189,1312098,161,20498,155250,24882471,20254,1494172,15614,1198934,35,19189,234319
5262,11/29/2020,California,State,40129160,16124,1328222,129,20627,114329,24996800,12824,1506996,14034,1212968,31,19220,217670
5263,11/30/2020,California,State,40129160,32700,1360922,161,20788,372837,25369637,36715,1543711,12221,1225189,29,19249,136142
5264,12/1/2020,California,State,40129160,34505,1395427,162,20950,379634,25749271,38043,1581754,20762,1245951,119,19368,137813
5265,12/2/2020,California,State,40129160,33598,1429025,175,21125,354482,26103753,38780,1620534,18588,1264539,113,19481,175516
5266,12/3/2020,California,State,40129160,32009,1461034,219,21344,349487,26453240,38879,1659413,22018,1286557,201,19682,200836
5267,12/4/2020,California,State,40129160,32031,1493065,198,21542,331438,26784678,37881,1697294,25068,1311625,126,19808,226497
5268,12/5/2020,California,State,40129160,24521,1517586,239,21781,181025,26965703,26198,1723492,30075,1341700,122,19930,293071
5269,12/6/2020,California,State,40129160,18473,1536059,235,22016,121886,27087589,16216,1739708,24735,1366435,98,20028,298305
5270,12/7/2020,California,State,40129160,41230,1577289,264,22280,395973,27483562,46117,1785825,23272,1389707,59,20087,296424
5271,12/8/2020,California,State,40129160,41496,1618785,229,22509,387297,27870859,47468,1833293,30851,1420558,168,20255,252296
5272,12/9/2020,California,State,40129160,41781,1660566,253,22762,371801,28242660,48270,1881563,29677,1450235,203,20458,282261
5273,12/10/2020,California,State,40129160,40938,1701504,316,23078,353945,28596605,46934,1928497,35468,1485703,185,20643,248011
5274,12/11/2020,California,State,40129160,40167,1741671,300,23378,332127,28928732,45079,1973576,35729,1521432,169,20812,313787
5275,12/12/2020,California,State,40129160,30859,1772530,284,23662,192842,29121574,32717,2006293,30334,1551766,183,20995,309457
5276,12/13/2020,California,State,40129160,21076,1793606,340,24002,130809,29252383,19131,2025424,33278,1585044,93,21088,356452
5277,12/14/2020,California,State,40129160,49491,1843097,358,24360,413662,29666045,54768,2080192,32326,1617370,90,21178,293027
5278,12/15/2020,California,State,40129160,48510,1891607,382,24742,409751,30075796,57826,2138018,53711,1671081,232,21410,304524
5279,12/16/2020,California,State,40129160,45974,1937581,373,25115,398187,30473983,55792,2193810,52281,1723362,407,21817,306768
5280,12/17/2020,California,State,40129160,44706,1982287,396,25511,397870,30871853,55225,2249035,41012,1764374,263,22080,284669
5281,12/18/2020,California,State,40129160,41828,2024115,465,25976,362265,31234118,50866,2299901,43608,1807982,266,22346,371222
5282,12/19/2020,California,State,40129160,29923,2054038,467,26443,210345,31444463,34760,2334661,46474,1854456,225,22571,352921
5283,12/20/2020,California,State,40129160,21104,2075142,447,26890,145776,31590239,19796,2354457,37892,1892348,144,22715,395234
5284,12/21/2020,California,State,40129160,48549,2123691,495,27385,448451,32038690,57433,2411890,32659,1925007,111,22826,329778
5285,12/22/2020,California,State,40129160,49039,2172730,538,27923,425283,32463973,59243,2471133,39069,1964076,271,23097,278378
5286,12/23/2020,California,State,40129160,45384,2218114,504,28427,385950,32849923,56101,2527234,34039,1998115,287,23384,301189
5287,12/24/2020,California,State,40129160,26969,2245083,555,28982,180128,33030051,27045,2554279,44175,2042290,340,23724,297112
5288,12/25/2020,California,State,40129160,13457,2258540,573,29555,39886,33069937,7585,2561864,30375,2072665,178,23902,379681
5289,12/26/2020,California,State,40129160,34795,2293335,598,30153,195740,33265677,40341,2602205,50141,2122806,219,24121,380154
5290,12/27/2020,California,State,40129160,26535,2319870,588,30741,143415,33409092,24342,2626547,33170,2155976,74,24195,301820
5291,12/28/2020,California,State,40129160,58083,2377953,626,31367,425628,33834720,66149,2692696,31245,2187221,116,24311,245955
5292,12/29/2020,California,State,40129160,58569,2436522,588,31955,426574,34261294,73328,2766024,30921,2218142,427,24738,248605
5293,12/30/2020,California,State,40129160,53973,2490495,627,32582,398308,34659602,68020,2834044,13410,2231552,636,25374,232406
5294,12/31/2020,California,State,40129160,35649,2526144,646,33228,236058,34895660,38510,2872554,61016,2292568,428,25802,202829
5295,1/1/2021,California,State,40129160,19834,2545978,661,33889,59601,34955261,10929,2883483,53341,2345909,434,26236,333131
5296,1/2/2021,California,State,40129160,37400,2583378,642,34531,219481,35174742,43805,2927288,45352,2391261,258,26494,421344
5297,1/3/2021,California,State,40129160,27232,2610610,675,35206,159625,35334367,25654,2952942,18442,2409703,-14,26480,314227
5298,1/4/2021,California,State,40129160,60488,2671098,700,35906,479707,35814074,71238,3024180,42631,2452334,327,26807,203771
5299,1/5/2021,California,State,40129160,54794,2725892,709,36615,462895,36276969,69371,3093551,29892,2482226,415,27222,217837
5300,1/6/2021,California,State,40129160,50435,2776327,694,37309,430291,36707260,63064,3156615,36385,2518611,589,27811,211734
5301,1/7/2021,California,State,40129160,44958,2821285,709,38018,414672,37121932,58003,3214618,50030,2568641,555,28366,266975
5302,1/8/2021,California,State,40129160,40991,2862276,680,38698,369037,37490969,53009,3267627,52636,2621277,630,28996,326418
5303,1/9/2021,California,State,40129160,28558,2890834,687,39385,209387,37700356,34953,3302580,49685,2670962,500,29496,473076
5304,1/10/2021,California,State,40129160,19123,2909957,680,40065,145731,37846087,19096,3321676,39839,2710801,415,29911,343704
5305,1/11/2021,California,State,40129160,41947,2951904,706,40771,461868,38307955,53475,3375151,36487,2747288,194,30105,337856
5306,1/12/2021,California,State,40129160,38589,2990493,716,41487,422489,38730444,50315,3425466,33751,2781039,580,30685,334267
5307,1/13/2021,California,State,40129160,34630,3025123,631,42118,394680,39125124,46101,3471567,35930,2816969,537,31222,287715
5308,1/14/2021,California,State,40129160,31794,3056917,656,42774,385117,39510241,44358,3515925,42655,2859624,425,31647,319170
5309,1/15/2021,California,State,40129160,28981,3085898,710,43484,336119,39846360,39813,3555738,40622,2900246,603,32250,352719
5310,1/16/2021,California,State,40129160,19949,3105847,625,44109,174875,40021235,26003,3581741,42229,2942475,563,32813,426360
5311,1/17/2021,California,State,40129160,13621,3119468,642,44751,118410,40139645,14631,3596372,30699,2973174,326,33139,427141
5312,1/18/2021,California,State,40129160,23574,3143042,604,45355,300594,40440239,28772,3625144,23794,2996968,225,33364,368787
5313,1/19/2021,California,State,40129160,27319,3170361,594,45949,402129,40842368,37263,3662407,22403,3019371,326,33690,263820
5314,1/20/2021,California,State,40129160,25155,3195516,607,46556,355162,41197530,33633,3696040,19673,3039044,655,34345,224393
5315,1/21/2021,California,State,40129160,22028,3217544,567,47123,352227,41549757,31896,3727936,23024,3062068,684,35029,213083
5316,1/22/2021,California,State,40129160,19703,3237247,552,47675,306291,41856048,28859,3756795,22972,3085040,515,35544,244280
5317,1/23/2021,California,State,40129160,13449,3250696,502,48177,140294,41996342,17399,3774194,24111,3109151,664,36208,315596
5318,1/24/2021,California,State,40129160,10373,3261069,457,48634,107886,42104228,11512,3785706,27007,3136158,240,36448,403193
5319,1/25/2021,California,State,40129160,20110,3281179,515,49149,352756,42456984,26784,3812490,17028,3153186,212,36660,321862
5320,1/26/2021,California,State,40129160,17776,3298955,499,49648,324956,42781940,25464,3837954,16728,3169914,666,37326,218152
5321,1/27/2021,California,State,40129160,15739,3314694,463,50111,287219,43069159,22343,3860297,16696,3186610,744,38070,206771
5322,1/28/2021,California,State,40129160,14580,3329274,466,50577,286153,43355312,20947,3881244,19337,3205947,597,38667,303051
5323,1/29/2021,California,State,40129160,12768,3342042,458,51035,250020,43605332,18527,3899771,18427,3224374,656,39323,298562
5324,1/30/2021,California,State,40129160,10070,3352112,438,51473,129874,43735206,14772,3914543,18974,3243348,590,39913,290175
5325,1/31/2021,California,State,40129160,7962,3360074,415,51888,102181,43837387,8545,3923088,15358,3258706,350,40263,282698
5326,2/1/2021,California,State,40129160,15273,3375347,482,52370,352628,44190015,21390,3944478,12064,3270770,194,40457,215342
5327,2/2/2021,California,State,40129160,12636,3387983,400,52770,317609,44507624,19379,3963857,10501,3281271,561,41018,168094
5328,2/3/2021,California,State,40129160,11532,3399515,386,53156,296781,44804405,18569,3982426,13176,3294447,616,41634,197777
5329,2/4/2021,California,State,40129160,10158,3409673,369,53525,290551,45094956,16458,3998884,14021,3308468,779,42413,286051
5330,2/5/2021,California,State,40129160,9447,3419120,405,53930,255256,45350212,15621,4014505,12394,3320862,605,43018,275167
5331,2/6/2021,California,State,40129160,6674,3425794,312,54242,119712,45469924,9946,4024451,15064,3335926,438,43456,329228
5332,2/7/2021,California,State,40129160,5148,3430942,316,54558,92672,45562596,6147,4030598,10414,3346340,279,43735,259754
5333,2/8/2021,California,State,40129160,9441,3440383,335,54893,326634,45889230,14253,4044851,8251,3354591,170,43905,187297
5334,2/9/2021,California,State,40129160,7732,3448115,320,55213,298772,46188002,12492,4057343,8390,3362981,520,44425,153380
5335,2/10/2021,California,State,40129160,7505,3455620,326,55539,268622,46456624,11713,4069056,8575,3371556,565,44990,201460
5336,2/11/2021,California,State,40129160,6595,3462215,331,55870,254567,46711191,10589,4079645,10059,3381615,530,45520,286196
5337,2/12/2021,California,State,40129160,6191,3468406,294,56164,204636,46915827,9526,4089171,9421,3391036,466,45986,291580
5338,2/13/2021,California,State,40129160,4446,3472852,251,56415,95915,47011742,6386,4095557,8842,3399878,471,46457,260910
5339,2/14/2021,California,State,40129160,3527,3476379,243,56658,67652,47079394,3968,4099525,6487,3406365,262,46719,263598
5340,2/15/2021,California,State,40129160,5253,3481632,243,56901,198336,47277730,7271,4106796,5692,3412057,76,46795,157207
5341,2/16/2021,California,State,40129160,5630,3487262,244,57145,291794,47569524,9280,4116076,4090,3416147,291,47086,119323
5342,2/17/2021,California,State,40129160,5077,3492339,237,57382,247227,47816751,7964,4124040,5573,3421720,451,47537,117399
5343,2/18/2021,California,State,40129160,4403,3496742,228,57610,233450,48050201,6992,4131032,6798,3428518,436,47973,192222
5344,2/19/2021,California,State,40129160,4180,3500922,245,57855,202619,48252820,6616,4137648,6668,3435186,441,48414,229472
5345,2/20/2021,California,State,40129160,3103,3504025,196,58051,92730,48345550,4389,4142037,6760,3441946,393,48807,277454
5346,2/21/2021,California,State,40129160,2628,3506653,190,58241,80025,48425575,3076,4145113,4665,3446611,232,49039,
5347,2/22/2021,California,State,40129160,4625,3511278,191,58432,273550,48699125,6787,4151900,3447,3450058,90,49129,138805
5348,2/23/2021,California,State,40129160,4027,3515305,166,58598,255894,48955019,6045,4157945,5303,3455361,341,49470,161988
5349,2/24/2021,California,State,40129160,3875,3519180,167,58765,238810,49193829,5815,4163760,4965,3460326,1178,50648,181416
5350,2/25/2021,California,State,40129160,3453,3522633,161,58926,215297,49409126,5167,4168927,5400,3465726,473,51121,223914
5351,2/26/2021,California,State,40129160,3359,3525992,156,59082,189470,49598596,4984,4173911,5151,3470877,384,51505,249616
5352,2/27/2021,California,State,40129160,2523,3528515,162,59244,86520,49685116,3390,4177301,4685,3475562,289,51794,243570
5353,2/28/2021,California,State,40129160,2186,3530701,159,59403,75746,49760862,2265,4179566,3516,3479078,238,52032,184514
5354,3/1/2021,California,State,40129160,3756,3534457,126,59529,276439,50037301,5065,4184631,2533,3481611,97,52129,130858
5355,3/2/2021,California,State,40129160,3260,3537717,132,59661,247136,50284437,4779,4189410,3352,3484963,300,52429,119637
5356,3/3/2021,California,State,40129160,3201,3540918,119,59780,223730,50508167,4606,4194016,3504,3488467,394,52823,146818
5357,3/4/2021,California,State,40129160,2937,3543855,119,59899,206480,50714647,4328,4198344,4659,3493126,371,53194,218325
5358,3/5/2021,California,State,40129160,2942,3546797,109,60008,180166,50894813,4044,4202388,4452,3497578,270,53464,133186
5359,3/6/2021,California,State,40129160,2197,3548994,104,60112,79110,50973923,2728,4205116,3816,3501394,258,53722,276485
5360,3/7/2021,California,State,40129160,1948,3550942,88,60200,73928,51047851,2030,4207146,3258,3504652,106,53828,217332
5361,3/8/2021,California,State,40129160,3334,3554276,98,60298,270319,51318170,4521,4211667,2614,3507266,50,53878,84140
5362,3/9/2021,California,State,40129160,2830,3557106,94,60392,241111,51559281,3990,4215657,6412,3513678,442,54320,92180
5363,3/10/2021,California,State,40129160,2759,3559865,89,60481,218484,51777765,3797,4219454,3184,3516862,270,54590,215438
5364,3/11/2021,California,State,40129160,2593,3562458,85,60566,198162,51975927,3868,4223322,3471,3520333,288,54878,240987
5365,3/12/2021,California,State,40129160,2498,3564956,85,60651,176704,52152631,3613,4226935,3230,3523563,217,55095,226580
5366,3/13/2021,California,State,40129160,1896,3566852,77,60728,78572,52231203,2394,4229329,2772,3526335,140,55235,213283
5367,3/14/2021,California,State,40129160,1605,3568457,62,60790,62191,52293394,1700,4231029,2460,3528795,95,55330,167229
5368,3/15/2021,California,State,40129160,2878,3571335,58,60848,266042,52559436,3931,4234960,1260,3530055,42,55372,88299
5369,3/16/2021,California,State,40129160,2510,3573845,72,60920,242686,52802122,3844,4238804,2441,3532496,205,55577,
5370,3/17/2021,California,State,40129160,2637,3576482,82,61002,228079,53030201,3829,4242633,3038,3535534,218,55795,88299
5371,3/18/2021,California,State,40129160,2218,3578700,79,61081,193360,53223561,3324,4245957,3287,3538821,232,56027,211492
5372,3/19/2021,California,State,40129160,2178,3580878,56,61137,178089,53401650,3287,4249244,3107,3541928,45,56072,230712
5373,3/20/2021,California,State,40129160,1714,3582592,78,61215,77977,53479627,2096,4251340,3350,3545278,46,56118,212625
5374,3/21/2021,California,State,40129160,1603,3584195,51,61266,63353,53542980,1685,4253025,2000,3547278,427,56545,160229
5375,3/22/2021,California,State,40129160,2704,3586899,53,61319,271885,53814865,3651,4256676,1823,3549101,51,56596,116641
5376,3/23/2021,California,State,40129160,2508,3589407,38,61357,235190,54050055,3354,4260030,1955,3551056,254,56850,106179
5377,3/24/2021,California,State,40129160,2676,3592083,57,61414,223077,54273132,3776,4263806,2251,3553307,241,57091,137122
5378,3/25/2021,California,State,40129160,2292,3594375,57,61471,200009,54473141,3362,4267168,2608,3555915,245,57336,200192
5379,3/26/2021,California,State,40129160,2268,3596643,55,61526,166367,54639508,3146,4270314,3278,3559193,215,57551,
5380,3/27/2021,California,State,40129160,1669,3598312,49,61575,75586,54715094,2023,4272337,2998,3562191,195,57746,217271
5381,3/28/2021,California,State,40129160,1603,3599915,29,61604,65126,54780220,1529,4273866,2277,3564468,32,57778,174999
5382,3/29/2021,California,State,40129160,2710,3602625,44,61648,266533,55046753,3624,4277490,1996,3566464,10,57788,127906
5383,3/30/2021,California,State,40129160,2430,3605055,39,61687,234139,55280892,3282,4280772,1962,3568426,148,57936,103017
5384,3/31/2021,California,State,40129160,2382,3607437,49,61736,192839,55473731,3331,4284103,2234,3570660,154,58090,150435
5385,4/1/2021,California,State,40129160,2339,3609776,39,61775,186449,55660180,3126,4287229,2414,3573074,179,58269,251606
5386,4/2/2021,California,State,40129160,2235,3612011,35,61810,156709,55816889,3085,4290314,4877,3577951,135,58404,341529
5387,4/3/2021,California,State,40129160,1706,3613717,29,61839,75085,55891974,2044,4292358,2400,3580351,109,58513,191684
5388,4/4/2021,California,State,40129160,1552,3615269,39,61878,51291,55943265,1275,4293633,2112,3582463,21,58534,190179
5389,4/5/2021,California,State,40129160,2874,3618143,40,61918,280313,56223578,3757,4297390,1367,3583830,7,58541,100015
5390,4/6/2021,California,State,40129160,2550,3620693,22,61940,245143,56468721,3346,4300736,2229,3586059,118,58659,106309
5391,4/7/2021,California,State,40129160,2616,3623309,39,61979,228865,56697586,3490,4304226,2093,3588152,129,58788,126557
5392,4/8/2021,California,State,40129160,2277,3625586,37,62016,204143,56901729,3169,4307395,2606,3590758,155,58943,217451
5393,4/9/2021,California,State,40129160,2274,3627860,38,62054,184469,57086198,3231,4310626,4466,3595224,170,59113,216028
5394,4/10/2021,California,State,40129160,1816,3629676,37,62091,82063,57168261,2173,4312799,4954,3600178,105,59218,239453
5395,4/11/2021,California,State,40129160,1566,3631242,32,62123,69631,57237892,1628,4314427,2649,3602827,31,59249,229596
5396,4/12/2021,California,State,40129160,2712,3633954,32,62155,310027,57547919,3679,4318106,1568,3604395,9,59258,129157
5397,4/13/2021,California,State,40129160,2418,3636372,31,62186,261366,57809285,3311,4321417,2487,3606882,114,59372,115110
5398,4/14/2021,California,State,40129160,2385,3638757,39,62225,247963,58057248,3393,4324810,2016,3608898,136,59508,159794
5399,4/15/2021,California,State,40129160,2113,3640870,30,62255,224561,58281809,3092,4327902,2451,3611349,79,59587,231480
5400,4/16/2021,California,State,40129160,2053,3642923,26,62281,203343,58485152,3144,4331046,2763,3614112,103,59690,252314
5401,4/17/2021,California,State,40129160,1551,3644474,28,62309,93589,58578741,1933,4332979,2667,3616779,78,59768,252334
5402,4/18/2021,California,State,40129160,1429,3645903,28,62337,72062,58650803,1504,4334483,1916,3618695,4,59772,200627
5403,4/19/2021,California,State,40129160,2435,3648338,34,62371,302528,58953331,3271,4337754,1606,3620301,32,59804,141833
5404,4/20/2021,California,State,40129160,2127,3650465,25,62396,265388,59218719,2876,4340630,2126,3622427,86,59890,126493
5405,4/21/2021,California,State,40129160,1993,3652458,32,62428,250017,59468736,3001,4343631,2411,3624838,102,59992,254720
5406,4/22/2021,California,State,40129160,1840,3654298,20,62448,222015,59690751,2720,4346351,1818,3626656,94,60086,187526
5407,4/23/2021,California,State,40129160,1820,3656118,24,62472,198651,59889402,2716,4349067,1229,3627885,49,60135,251666
5408,4/24/2021,California,State,40129160,1372,3657490,25,62497,85638,59975040,1672,4350739,1739,3629624,53,60188,199392
5409,4/25/2021,California,State,40129160,1218,3658708,24,62521,71930,60046970,1313,4352052,2116,3631740,15,60203,231651
5410,4/26/2021,California,State,40129160,2104,3660812,26,62547,300031,60347001,2849,4354901,1445,3633185,5,60208,156757
5411,4/27/2021,California,State,40129160,1874,3662686,30,62577,261145,60608146,2619,4357520,1593,3634778,65,60273,137384
5412,4/28/2021,California,State,40129160,1821,3664507,16,62593,240652,60848798,2559,4360079,1457,3636235,89,60362,173688
5413,4/29/2021,California,State,40129160,1662,3666169,25,62618,212369,61061167,2488,4362567,1897,3638132,105,60467,220731
5414,4/30/2021,California,State,40129160,1645,3667814,18,62636,184481,61245648,2390,4364957,2094,3640226,158,60625,249872
5415,5/1/2021,California,State,40129160,1276,3669090,19,62655,73960,61319608,1542,4366499,2254,3642480,123,60748,249137
5416,5/2/2021,California,State,40129160,1102,3670192,19,62674,58841,61378449,1091,4367590,1512,3643992,15,60763,194834
5417,5/3/2021,California,State,40129160,1967,3672159,25,62699,286570,61665019,2600,4370190,1349,3645341,2,60765,148849
5418,5/4/2021,California,State,40129160,1598,3673757,23,62722,253520,61918539,2378,4372568,1388,3646729,97,60862,91130
5419,5/5/2021,California,State,40129160,1697,3675454,21,62743,233262,62151801,2294,4374862,1547,3648276,65,60927,142178
5420,5/6/2021,California,State,40129160,1525,3676979,30,62773,214022,62365823,2328,4377190,2471,3650747,100,61027,247021
5421,5/7/2021,California,State,40129160,1440,3678419,25,62798,180952,62546775,2118,4379308,1945,3652692,140,61167,246668
5422,5/8/2021,California,State,40129160,1049,3679468,19,62817,72162,62618937,1262,4380570,1853,3654545,61,61228,242054
5423,5/9/2021,California,State,40129160,939,3680407,24,62841,54364,62673301,908,4381478,1377,3655922,13,61241,223384
5424,5/10/2021,California,State,40129160,1633,3682040,11,62852,286925,62960226,2269,4383747,1045,3656967,5,61246,150925
5425,5/11/2021,California,State,40129160,1467,3683507,29,62881,253492,63213718,2205,4385952,1231,3658198,59,61305,124260
5426,5/12/2021,California,State,40129160,1350,3684857,33,62914,236629,63450347,2097,4388049,1443,3659641,46,61351,144550
5427,5/13/2021,California,State,40129160,1196,3686053,27,62941,208097,63658444,1820,4389869,2034,3661675,66,61417,219570
5428,5/14/2021,California,State,40129160,1179,3687232,18,62959,177486,63835930,1796,4391665,1864,3663539,27,61444,251185
5429,5/15/2021,California,State,40129160,898,3688130,18,62977,68613,63904543,1150,4392815,1370,3664909,55,61499,229177
5430,5/16/2021,California,State,40129160,813,3688943,15,62992,57573,63962116,902,4393717,995,3665904,11,61510,177223
5431,5/17/2021,California,State,40129160,1336,3690279,16,63008,275730,64237846,1957,4395674,687,3666591,3,61513,129983
5432,5/18/2021,California,State,40129160,1231,3691510,17,63025,241120,64478966,1853,4397527,959,3667550,42,61555,91321
5433,5/19/2021,California,State,40129160,1190,3692700,28,63053,226505,64705471,1696,4399223,1292,3668842,48,61603,143019
5434,5/20/2021,California,State,40129160,997,3693697,20,63073,200873,64906344,1584,4400807,1627,3670469,69,61672,228956
5435,5/21/2021,California,State,40129160,944,3694641,16,63089,173790,65080134,1460,4402267,1186,3671655,50,61722,238613
5436,5/22/2021,California,State,40129160,708,3695349,13,63102,64955,65145089,906,4403173,1308,3672963,33,61755,216936
5437,5/23/2021,California,State,40129160,663,3696012,22,63124,55639,65200728,728,4403901,1081,3674044,7,61762,179934
5438,5/24/2021,California,State,40129160,1207,3697219,24,63148,254675,65455403,1670,4405571,618,3674662,8,61770,132776
5439,5/25/2021,California,State,40129160,1042,3698261,15,63163,229902,65685305,1549,4407120,1155,3675817,54,61824,108670
5440,5/26/2021,California,State,40129160,981,3699242,17,63180,203397,65888702,1456,4408576,1418,3677235,31,61855,131867
5441,5/27/2021,California,State,40129160,920,3700162,19,63199,180392,66069094,1334,4409910,4864,3682099,170,62025,202116
5442,5/28/2021,California,State,40129160,862,3701024,12,63211,153824,66222918,1252,4411162,1210,3683309,-26,61999,225324
5443,5/29/2021,California,State,40129160,603,3701627,24,63235,59252,66282170,745,4411907,1079,3684388,7,62006,208712
5444,5/30/2021,California,State,40129160,585,3702212,10,63245,52004,66334174,650,4412557,644,3685032,5,62011,157610
5445,5/31/2021,California,State,40129160,597,3702809,15,63260,60544,66394718,527,4413084,423,3685455,10,62021,114673
5446,6/1/2021,California,State,40129160,1210,3704019,14,63274,281112,66675830,1704,4414788,461,3685916,23,62044,73534
5447,6/2/2021,California,State,40129160,1044,3705063,19,63293,219064,66894894,1428,4416216,773,3686689,48,62092,77814
5448,6/3/2021,California,State,40129160,996,3706059,12,63305,189252,67084146,1298,4417514,1047,3687736,87,62179,142365
5449,6/4/2021,California,State,40129160,850,3706909,14,63319,176577,67260723,1309,4418823,1157,3688893,63,62242,215195
5450,6/5/2021,California,State,40129160,641,3707550,12,63331,74605,67335328,848,4419671,1101,3689994,228,62470,215290
5451,6/6/2021,California,State,40129160,609,3708159,13,63344,58462,67393790,662,4420333,874,3690868,3,62473,180142
5452,6/7/2021,California,State,40129160,1039,3709198,12,63356,212283,67606073,1499,4421832,792,3691660,6,62479,155298
5453,6/8/2021,California,State,40129160,1050,3710248,13,63369,185361,67791434,1352,4423184,846,3692506,20,62499,95819
5454,6/9/2021,California,State,40129160,928,3711176,7,63376,157194,67948628,1264,4424448,856,3693362,39,62538,128329
5455,6/10/2021,California,State,40129160,876,3712052,15,63391,159297,68107925,1191,4425639,1136,3694498,55,62593,179633
5456,6/11/2021,California,State,40129160,853,3712905,11,63402,141547,68249472,1206,4426845,1032,3695530,-85,62508,175689
5457,6/12/2021,California,State,40129160,678,3713583,10,63412,64372,68313844,765,4427610,942,3696472,4,62512,147121
5458,6/13/2021,California,State,40129160,705,3714288,12,63424,54326,68368170,639,4428249,827,3697299,-7,62505,144468
5459,6/14/2021,California,State,40129160,1152,3715440,14,63438,167571,68535741,1485,4429734,628,3697927,10,62515,112248
5460,6/15/2021,California,State,40129160,1046,3716486,14,63452,149914,68685655,1278,4431012,699,3698626,19,62534,87672
5461,6/16/2021,California,State,40129160,1063,3717549,10,63462,137636,68823291,1391,4432403,829,3699455,31,62565,109057
5462,6/17/2021,California,State,40129160,1026,3718575,11,63473,124864,68948155,1375,4433778,1295,3700750,57,62622,156249
5463,6/18/2021,California,State,40129160,929,3719504,11,63484,121029,69069184,1283,4435061,1176,3701926,32,62654,145609
5464,6/19/2021,California,State,40129160,753,3720257,9,63493,62312,69131496,928,4435989,956,3702882,35,62689,133146
5465,6/20/2021,California,State,40129160,800,3721057,7,63500,49058,69180554,664,4436653,1123,3704005,4,62693,113272
5466,6/21/2021,California,State,40129160,1401,3722458,11,63511,162980,69343534,1621,4438274,635,3704640,8,62701,81617
5467,6/22/2021,California,State,40129160,1310,3723768,14,63525,148997,69492531,1661,4439935,787,3705427,40,62741,71487
5468,6/23/2021,California,State,40129160,1232,3725000,7,63532,139500,69632031,1626,4441561,1419,3706846,81,62822,103581
5469,6/24/2021,California,State,40129160,1395,3726395,11,63543,125121,69757152,1816,4443377,2015,3708861,68,62890,143881
5470,6/25/2021,California,State,40129160,1308,3727703,10,63553,120605,69877757,1617,4444994,1683,3710544,55,62945,164049
5471,6/26/2021,California,State,40129160,1075,3728778,17,63570,62462,69940219,1137,4446131,2251,3712795,45,62990,113060
5472,6/27/2021,California,State,40129160,1171,3729949,10,63580,51607,69991826,953,4447084,1256,3714051,4,62994,118346
5473,6/28/2021,California,State,40129160,1932,3731881,14,63594,161423,70153249,2289,4449373,762,3714813,5,62999,113653
5474,6/29/2021,California,State,40129160,1886,3733767,12,63606,152993,70306242,2261,4451634,-4359,3710454,24,63023,49652
5475,6/30/2021,California,State,40129160,2023,3735790,18,63624,144282,70450524,2416,4454050,1698,3712152,73,63096,81601
5476,7/1/2021,California,State,40129160,2159,3737949,14,63638,132787,70583311,2526,4456576,1792,3713944,45,63141,160638
5477,7/2/2021,California,State,40129160,2020,3739969,14,63652,109585,70692896,2419,4458995,0,3713944,0,63141,
5478,7/3/2021,California,State,40129160,1680,3741649,12,63664,64229,70757125,1715,4460710,0,3713944,0,63141,
5479,7/4/2021,California,State,40129160,1555,3743204,6,63670,27983,70785108,781,4461491,0,3713944,0,63141,
5480,7/5/2021,California,State,40129160,2789,3745993,14,63684,79618,70864726,2208,4463699,5730,3719674,97,63238,498811
5481,7/6/2021,California,State,40129160,3608,3749601,15,63699,184939,71049665,4006,4467705,1332,3721006,21,63259,45230
5482,7/7/2021,California,State,40129160,3751,3753352,16,63715,153921,71203586,4291,4471996,1416,3722422,58,63317,63763
5483,7/8/2021,California,State,40129160,3569,3756921,15,63730,140479,71344065,4486,4476482,2411,3724833,59,63376,121341
5484,7/9/2021,California,State,40129160,3601,3760522,20,63750,132704,71476769,4569,4481051,0,3724833,0,63376,
5485,7/10/2021,California,State,40129160,3131,3763653,19,63769,64535,71541304,3335,4484386,0,3724833,0,63376,
5486,7/11/2021,California,State,40129160,3131,3766784,17,63786,51350,71592654,2728,4487114,8910,3733743,96,63472,
5487,7/12/2021,California,State,40129160,5370,3772154,18,63804,163483,71756137,5711,4492825,3256,3736999,6,63478,102460
5488,7/13/2021,California,State,40129160,5398,3777552,20,63824,157090,71913227,5748,4498573,3093,3740092,30,63508,81537
5489,7/14/2021,California,State,40129160,5561,3783113,14,63838,158827,72072054,6666,4505239,3622,3743714,25,63533,105754
5490,7/15/2021,California,State,40129160,5861,3788974,21,63859,151193,72223247,7283,4512522,4651,3748365,65,63598,130709
5491,7/16/2021,California,State,40129160,5973,3794947,19,63878,151146,72374393,7454,4519976,0,3748365,0,63598,
5492,7/17/2021,California,State,40129160,4674,3799621,24,63902,76719,72451112,5293,4525269,0,3748365,0,63598,
5493,7/18/2021,California,State,40129160,4806,3804427,12,63914,61254,72512366,4235,4529504,14097,3762462,51,63649,481319
5494,7/19/2021,California,State,40129160,8397,3812824,27,63941,195779,72708145,9793,4539297,4723,3767185,4,63653,94774
5495,7/20/2021,California,State,40129160,8359,3821183,30,63971,194241,72902386,10030,4549327,5285,3772470,11,63664,122156
5496,7/21/2021,California,State,40129160,8784,3829967,23,63994,192007,73094393,10824,4560151,5577,3778047,31,63695,111325
5497,7/22/2021,California,State,40129160,8329,3838296,34,64028,183052,73277445,10711,4570862,7984,3786031,46,63741,173866
5498,7/23/2021,California,State,40129160,8132,3846428,41,64069,177637,73455082,10910,4581772,0,3786031,0,63741,
5499,7/24/2021,California,State,40129160,6766,3853194,24,64093,92595,73547677,7681,4589453,0,3786031,0,63741,
5500,7/25/2021,California,State,40129160,6431,3859625,31,64124,71453,73619130,6229,4595682,21940,3807971,65,63806,565365
5501,7/26/2021,California,State,40129160,11728,3871353,27,64151,224998,73844128,14266,4609948,7731,3815702,5,63811,128412
5502,7/27/2021,California,State,40129160,11252,3882605,36,64187,218621,74062749,14292,4624240,6849,3822551,38,63849,116448
5503,7/28/2021,California,State,40129160,11799,3894404,35,64222,219615,74282364,15272,4639512,7457,3830008,42,63891,129545
5504,7/29/2021,California,State,40129160,11718,3906122,40,64262,218925,74501289,16309,4655821,10356,3840364,44,63935,185144
5505,7/30/2021,California,State,40129160,11081,3917203,32,64294,216774,74718063,15199,4671020,0,3840364,0,63935,
5506,7/31/2021,California,State,40129160,8494,3925697,53,64347,114508,74832571,10652,4681672,0,3840364,0,63935,
5507,8/1/2021,California,State,40129160,8531,3934228,39,64386,86941,74919512,7914,4689586,33407,3873771,150,64085,609327
5508,8/2/2021,California,State,40129160,14105,3948333,59,64445,282398,75201910,17309,4706895,7318,3881089,11,64096,154929
5509,8/3/2021,California,State,40129160,14318,3962651,58,64503,285472,75487382,18875,4725770,8552,3889641,54,64150,133078
5510,8/4/2021,California,State,40129160,14083,3976734,53,64556,295046,75782428,18832,4744602,9517,3899158,56,64206,156092
5511,8/5/2021,California,State,40129160,13931,3990665,54,64610,302132,76084560,19563,4764165,14402,3913560,37,64243,250620
5512,8/6/2021,California,State,40129160,12882,4003547,61,64671,284005,76368565,18340,4782505,12916,3926476,33,64276,278816
5513,8/7/2021,California,State,40129160,9698,4013245,61,64732,144424,76512989,12448,4794953,13271,3939747,36,64312,255214
5514,8/8/2021,California,State,40129160,8718,4021963,72,64804,96979,76609968,8717,4803670,10425,3950172,6,64318,257510
5515,8/9/2021,California,State,40129160,16281,4038244,75,64879,371515,76981483,20284,4823954,9625,3959797,10,64328,198041
5516,8/10/2021,California,State,40129160,16187,4054431,77,64956,347394,77328877,20595,4844549,9925,3969722,-352,63976,183877
5517,8/11/2021,California,State,40129160,15492,4069923,78,65034,369423,77698300,20450,4864999,10450,3980172,61,64037,170150
5518,8/12/2021,California,State,40129160,14578,4084501,90,65124,349653,78047953,20369,4885368,14099,3994271,61,64098,281144
5519,8/13/2021,California,State,40129160,13735,4098236,120,65244,323329,78371282,19335,4904703,14479,4008750,40,64138,298050
5520,8/14/2021,California,State,40129160,9580,4107816,92,65336,167106,78538388,12970,4917673,13472,4022222,45,64183,309456
5521,8/15/2021,California,State,40129160,8184,4116000,78,65414,104413,78642801,8979,4926652,11437,4033659,11,64194,271306
5522,8/16/2021,California,State,40129160,16100,4132100,120,65534,418727,79061528,21315,4947967,9748,4043407,7,64201,263855
5523,8/17/2021,California,State,40129160,15497,4147597,119,65653,411204,79472732,21056,4969023,14317,4057724,90,64291,254504
5524,8/18/2021,California,State,40129160,15037,4162634,105,65758,429118,79901850,20433,4989456,12359,4070083,92,64383,254334
5525,8/19/2021,California,State,40129160,13888,4176522,113,65871,411048,80312898,19746,5009202,14716,4084799,120,64503,339264
5526,8/20/2021,California,State,40129160,13401,4189923,106,65977,392565,80705463,19127,5028329,13613,4098412,82,64585,311111
5527,8/21/2021,California,State,40129160,8877,4198800,118,66095,159691,80865154,11709,5040038,14564,4112976,89,64674,321082
5528,8/22/2021,California,State,40129160,7544,4206344,108,66203,104943,80970097,8021,5048059,10274,4123250,3,64677,312540
5529,8/23/2021,California,State,40129160,15323,4221667,115,66318,468103,81438200,19796,5067855,10401,4133651,17,64694,280293
5530,8/24/2021,California,State,40129160,14040,4235707,128,66446,444459,81882659,19063,5086918,11899,4145550,108,64802,262080
5531,8/25/2021,California,State,40129160,13554,4249261,129,66575,473029,82355688,19332,5106250,11769,4157319,129,64931,285999
5532,8/26/2021,California,State,40129160,12390,4261651,137,66712,449594,82805282,18538,5124788,13785,4171104,102,65033,366362
5533,8/27/2021,California,State,40129160,11246,4272897,129,66841,402015,83207297,16283,5141071,15157,4186261,106,65139,451714
5534,8/28/2021,California,State,40129160,7802,4280699,149,66990,154050,83361347,10108,5151179,11828,4198089,104,65243,378087
5535,8/29/2021,California,State,40129160,6589,4287288,118,67108,105282,83466629,6977,5158156,14968,4213057,28,65271,390730
5536,8/30/2021,California,State,40129160,13270,4300558,124,67232,507050,83973679,17802,5175958,9606,4222663,16,65287,305522
5537,8/31/2021,California,State,40129160,12260,4312818,139,67371,477257,84450936,16895,5192853,23387,4246050,143,65430,532560
5538,9/1/2021,California,State,40129160,12917,4325735,132,67503,488840,84939776,16387,5209240,10194,4256244,155,65585,287939
5539,9/2/2021,California,State,40129160,10988,4336723,156,67659,462042,85401818,15151,5224391,11742,4267986,119,65704,343646
5540,9/3/2021,California,State,40129160,9957,4346680,146,67805,298167,85699985,13386,5237777,9318,4277304,103,65807,379161
5541,9/4/2021,California,State,40129160,6791,4353471,118,67923,142571,85842556,8456,5246233,14267,4291571,158,65965,410386
5542,9/5/2021,California,State,40129160,5367,4358838,151,68074,101610,85944166,5475,5251708,8866,4300437,25,65990,307179
5543,9/6/2021,California,State,40129160,6659,4365497,141,68215,132440,86076606,6596,5258304,7523,4307960,40,66030,324150
5544,9/7/2021,California,State,40129160,12390,4377887,135,68350,480330,86556936,17777,5276081,7274,4315234,26,66056,262309
5545,9/8/2021,California,State,40129160,11297,4389184,136,68486,520559,87077495,15335,5291416,7127,4322361,201,66257,232980
5546,9/9/2021,California,State,40129160,10164,4399348,142,68628,476510,87554005,14060,5305476,9244,4331605,165,66422,296579
5547,9/10/2021,California,State,40129160,9302,4408650,151,68779,415268,87969273,13109,5318585,13463,4345068,203,66625,503255
5548,9/11/2021,California,State,40129160,6242,4414892,128,68907,148706,88117979,7783,5326368,9045,4354113,76,66701,263474
5549,9/12/2021,California,State,40129160,5366,4420258,120,69027,106122,88224101,5607,5331975,6842,4360955,15,66716,225473
5550,9/13/2021,California,State,40129160,10419,4430677,142,69169,505541,88729642,14151,5346126,11851,4372806,97,66813,161247
5551,9/14/2021,California,State,40129160,9467,4440144,119,69288,478080,89207722,12787,5358913,7760,4380566,188,67001,816603
5552,9/15/2021,California,State,40129160,8853,4448997,130,69418,478108,89685830,12104,5371017,7360,4387926,186,67187,288542
5553,9/16/2021,California,State,40129160,7864,4456861,131,69549,330061,90015891,11187,5382204,9543,4397469,171,67358,364593
5554,9/17/2021,California,State,40129160,7313,4464174,130,69679,394930,90410821,10365,5392569,9385,4406854,125,67483,403179
5555,9/18/2021,California,State,40129160,4909,4469083,132,69811,138055,90548876,6042,5398611,9038,4415892,125,67608,415473
5556,9/19/2021,California,State,40129160,4138,4473221,99,69910,106306,90655182,4563,5403174,6193,4422085,4,67612,361546
5557,9/20/2021,California,State,40129160,8846,4482067,123,70033,476119,91131301,12151,5415325,6032,4428117,16,67628,305313
5558,9/21/2021,California,State,40129160,7539,4489606,102,70135,454898,91586199,10522,5425847,6579,4434696,146,67774,268385
5559,9/22/2021,California,State,40129160,7385,4496991,133,70268,449984,92036183,9948,5435795,6694,4441390,154,67928,216987
5560,9/23/2021,California,State,40129160,6478,4503469,127,70395,432998,92469181,9059,5444854,7276,4448666,159,68087,353193
5561,9/24/2021,California,State,40129160,6171,4509640,114,70509,365675,92834856,8717,5453571,0,4448666,0,68087,
5562,9/25/2021,California,State,40129160,4240,4513880,126,70635,121510,92956366,5172,5458743,0,4448666,0,68087,
5563,9/26/2021,California,State,40129160,3761,4517641,100,70735,92620,93048986,3914,5462657,22969,4471635,275,68362,1178025
5564,9/27/2021,California,State,40129160,7633,4525274,104,70839,469153,93518139,10409,5473066,4753,4476388,25,68387,294988
5565,9/28/2021,California,State,40129160,6775,4532049,107,70946,435960,93954099,9152,5482218,6493,4482881,130,68517,292767
5566,9/29/2021,California,State,40129160,6208,4538257,110,71056,439178,94393277,8442,5490660,5967,4488848,153,68670,281282
5567,9/30/2021,California,State,40129160,5792,4544049,92,71148,410404,94803681,7894,5498554,7869,4496717,126,68796,364616
5568,10/1/2021,California,State,40129160,5768,4549817,98,71246,348840,95152521,7522,5506076,0,4496717,0,68796,
5569,10/2/2021,California,State,40129160,3694,4553511,122,71368,109632,95262153,4411,5510487,0,4496717,0,68796,
5570,10/3/2021,California,State,40129160,3415,4556926,87,71455,88201,95350354,3433,5513920,18998,4515715,243,69039,1093475
5571,10/4/2021,California,State,40129160,6784,4563710,86,71541,454164,95804518,8729,5522649,3752,4519467,-12,69027,240120
5572,10/5/2021,California,State,40129160,6252,4569962,105,71646,406318,96210836,8056,5530705,5386,4524853,157,69184,137120
5573,10/6/2021,California,State,40129160,6010,4575972,113,71759,414596,96625432,7749,5538454,4710,4529563,167,69351,145348
5574,10/7/2021,California,State,40129160,5303,4581275,102,71861,388783,97014215,7194,5545648,6710,4536273,156,69507,594864
5575,10/8/2021,California,State,40129160,5160,4586435,85,71946,344902,97359117,7109,5552757,0,4536273,0,69507,
5576,10/9/2021,California,State,40129160,3509,4589944,77,72023,103847,97462964,4115,5556872,0,4536273,0,69507,
5577,10/10/2021,California,State,40129160,3309,4593253,82,72105,84777,97547741,3197,5560069,16921,4553194,234,69741,1098447
5578,10/11/2021,California,State,40129160,5831,4599084,74,72179,415076,97962817,7339,5567408,4091,4557285,15,69756,285722
5579,10/12/2021,California,State,40129160,5805,4604889,71,72250,426205,98389022,7841,5575249,4034,4561319,106,69862,221416
5580,10/13/2021,California,State,40129160,5632,4610521,68,72318,410421,98799443,7319,5582568,3960,4565279,148,70010,250718
5581,10/14/2021,California,State,40129160,5299,4615820,73,72391,397140,99196583,7040,5589608,6188,4571467,140,70150,338023
5582,10/15/2021,California,State,40129160,5314,4621134,68,72459,344867,99541450,6991,5596599,0,4571467,0,70150,
5583,10/16/2021,California,State,40129160,3650,4624784,79,72538,104008,99645458,4006,5600605,0,4571467,0,70150,
5584,10/17/2021,California,State,40129160,3596,4628380,77,72615,84216,99729674,3306,5603911,16764,4588231,266,70416,1347270
5585,10/18/2021,California,State,40129160,7070,4635450,71,72686,445893,100175567,8796,5612707,4081,4592312,21,70437,290083
5586,10/19/2021,California,State,40129160,6373,4641823,70,72756,418099,100593666,8006,5620713,3070,4595382,156,70593,221983
5587,10/20/2021,California,State,40129160,6252,4648075,69,72825,425274,101018940,7869,5628582,5124,4600506,148,70741,220598
5588,10/21/2021,California,State,40129160,5938,4654013,109,72934,401217,101420157,7914,5636496,6093,4606599,143,70884,306835
5589,10/22/2021,California,State,40129160,5984,4659997,79,73013,338763,101758920,7565,5644061,0,4606599,0,70884,
5590,10/23/2021,California,State,40129160,4076,4664073,73,73086,103907,101862827,4557,5648618,0,4606599,0,70884,
5591,10/24/2021,California,State,40129160,3587,4667660,68,73154,73328,101936155,3477,5652095,0,4606599,0,70884,1088730
5592,10/25/2021,California,State,40129160,7231,4674891,67,73221,411349,102347504,9297,5661392,24563,4631162,298,71182,1437508
5593,10/26/2021,California,State,40129160,6786,4681677,71,73292,420435,102767939,8836,5670228,4378,4635540,113,71295,151846
5594,10/27/2021,California,State,40129160,6579,4688256,69,73361,419384,103187323,8505,5678733,4949,4640489,113,71408,227069
5595,10/28/2021,California,State,40129160,6069,4694325,77,73438,394245,103581568,8096,5686829,7098,4647587,111,71519,282750
5596,10/29/2021,California,State,40129160,5639,4699964,73,73511,317929,103899497,7750,5694579,0,4647587,0,71519,
5597,10/30/2021,California,State,40129160,3952,4703916,81,73592,101694,104001191,4696,5699275,0,4647587,0,71519,
5598,10/31/2021,California,State,40129160,3510,4707426,66,73658,75351,104076542,3410,5702685,19351,4666938,13,71532,1211289
5599,11/1/2021,California,State,40129160,7423,4714849,78,73736,430816,104507358,9087,5711772,4209,4671147,38,71570,291857
5600,11/2/2021,California,State,40129160,6526,4721375,75,73811,416301,104923659,8448,5720220,3518,4674665,76,71646,205280
5601,11/3/2021,California,State,40129160,6428,4727803,74,73885,429846,105353505,8174,5728394,5608,4680273,113,71759,185196
5602,11/4/2021,California,State,40129160,6026,4733829,70,73955,401161,105754666,8160,5736554,8012,4688285,93,71852,311606
5603,11/5/2021,California,State,40129160,5555,4739384,73,74028,354522,106109188,7679,5744233,0,4688285,0,71852,
5604,11/6/2021,California,State,40129160,3683,4743067,81,74109,105990,106215178,4492,5748725,0,4688285,0,71852,
5605,11/7/2021,California,State,40129160,3467,4746534,92,74201,195819,106410997,3621,5752346,18893,4707178,127,71979,1107845
5606,11/8/2021,California,State,40129160,6677,4753211,76,74277,447382,106858379,8659,5761005,3945,4711123,19,71998,263636
5607,11/9/2021,California,State,40129160,5891,4759102,90,74367,453494,107311873,7919,5768924,3716,4714839,134,72132,173230
5608,11/10/2021,California,State,40129160,5657,4764759,71,74438,351532,107663405,7403,5776327,4757,4719596,156,72288,184125
5609,11/11/2021,California,State,40129160,4329,4769088,85,74523,291574,107954979,5464,5781791,0,4719596,0,72288,
5610,11/12/2021,California,State,40129160,5110,4774198,77,74600,258267,108213246,7088,5788879,11996,4731592,148,72436,895156
5611,11/13/2021,California,State,40129160,3463,4777661,67,74667,100556,108313802,4232,5793111,0,4731592,0,72436,
5612,11/14/2021,California,State,40129160,3260,4780921,76,74743,182666,108496468,3362,5796473,8410,4740002,134,72570,776565
5613,11/15/2021,California,State,40129160,6432,4787353,84,74827,426370,108922838,8344,5804817,4515,4744517,20,72590,254296
5614,11/16/2021,California,State,40129160,5418,4792771,63,74890,444220,109367058,7170,5811987,3912,4748429,128,72718,161317
5615,11/17/2021,California,State,40129160,5192,4797963,84,74974,415179,109782237,6982,5818969,4541,4752970,129,72847,189319
5616,11/18/2021,California,State,40129160,4703,4802666,70,75044,366697,110148934,6375,5825344,5327,4758297,153,73000,384689
5617,11/19/2021,California,State,40129160,4630,4807296,85,75129,239362,110388296,6246,5831590,0,4758297,0,73000,
5618,11/20/2021,California,State,40129160,3302,4810598,66,75195,102082,110490378,4008,5835598,0,4758297,0,73000,
5619,11/21/2021,California,State,40129160,2976,4813574,78,75273,91616,110581994,3144,5838742,15344,4773641,199,73199,1154877
5620,11/22/2021,California,State,40129160,5274,4818848,75,75348,293521,110875515,7128,5845870,4163,4777804,15,73214,
5621,11/23/2021,California,State,40129160,4860,4823708,80,75428,252074,111127589,6591,5852461,3063,4780867,151,73365,444850
5622,11/24/2021,California,State,40129160,4688,4828396,64,75492,189678,111317267,6086,5858547,0,4780867,0,73365,
5623,11/25/2021,California,State,40129160,2315,4830711,59,75551,30629,111347896,1215,5859762,0,4780867,0,73365,
5624,11/26/2021,California,State,40129160,4378,4835089,64,75615,123851,111471747,4930,5864692,0,4780867,0,73365,
5625,11/27/2021,California,State,40129160,4265,4839354,57,75672,111721,111583468,4874,5869566,0,4780867,0,73365,
5626,11/28/2021,California,State,40129160,4453,4843807,53,75725,200824,111784292,3886,5873452,20976,4801843,291,73656,866721
5627,11/29/2021,California,State,40129160,8375,4852182,77,75802,502751,112287043,10375,5883827,4667,4806510,56,73712,101999
5628,11/30/2021,California,State,40129160,7167,4859349,63,75865,467476,112754519,9016,5892843,3654,4810164,110,73822,132932
5629,12/1/2021,California,State,40129160,7591,4866940,70,75935,434183,113188702,8862,5901705,5113,4815277,97,73919,189904
5630,12/2/2021,California,State,40129160,6376,4873316,70,76005,393375,113582077,8340,5910045,7612,4822889,127,74046,265079
5631,12/3/2021,California,State,40129160,6225,4879541,68,76073,265197,113847274,7920,5917965,0,4822889,0,74046,
5632,12/4/2021,California,State,40129160,4216,4883757,75,76148,117089,113964363,4816,5922781,0,4822889,0,74046,
5633,12/5/2021,California,State,40129160,3924,4887681,64,76212,191826,114156189,3940,5926721,22406,4845295,163,74209,1498225
5634,12/6/2021,California,State,40129160,7501,4895182,52,76264,445584,114601773,9504,5936225,6134,4851429,12,74221,302754
5635,12/7/2021,California,State,40129160,6633,4901815,72,76336,461457,115063230,8557,5944782,4672,4856101,130,74351,207259
5636,12/8/2021,California,State,40129160,6583,4908398,58,76394,429250,115492480,8331,5953113,5251,4861352,81,74432,147433
5637,12/9/2021,California,State,40129160,5855,4914253,65,76459,379045,115871525,7795,5960908,6252,4867604,77,74509,356488
5638,12/10/2021,California,State,40129160,5848,4920101,57,76516,258719,116130244,7757,5968665,0,4867604,0,74509,
5639,12/11/2021,California,State,40129160,4244,4924345,64,76580,115430,116245674,4947,5973612,0,4867604,0,74509,
5640,12/12/2021,California,State,40129160,4426,4928771,59,76639,156302,116401976,3838,5977450,18905,4886509,176,74685,1240214
5641,12/13/2021,California,State,40129160,8990,4937761,69,76708,404297,116806273,9741,5987191,5476,4891985,19,74704,283751
5642,12/14/2021,California,State,40129160,8449,4946210,70,76778,386918,117193191,9049,5996240,4416,4896401,90,74794,173591
5643,12/15/2021,California,State,40129160,10237,4956447,72,76850,431200,117624391,12299,6008539,5494,4901895,85,74879,192204
5644,12/16/2021,California,State,40129160,10312,4966759,81,76931,394510,118018901,12653,6021192,7293,4909188,117,74996,353121
5645,12/17/2021,California,State,40129160,11194,4977953,68,76999,345088,118363989,13257,6034449,0,4909188,0,74996,
5646,12/18/2021,California,State,40129160,9798,4987751,65,77064,143987,118507976,10190,6044639,0,4909188,0,74996,
5647,12/19/2021,California,State,40129160,10865,4998616,76,77140,120246,118628222,8947,6053586,26273,4935461,171,75167,1197446
5648,12/20/2021,California,State,40129160,23321,5021937,70,77210,355856,118984078,24346,6077932,7766,4943227,-3,75164,293689
5649,12/21/2021,California,State,40129160,27332,5049269,67,77277,367100,119351178,31183,6109115,10903,4954130,117,75281,104437
5650,12/22/2021,California,State,40129160,31939,5081208,60,77337,385756,119736934,38394,6147509,15485,4969615,102,75383,291034
5651,12/23/2021,California,State,40129160,32658,5113866,75,77412,350436,120087370,40048,6187557,20401,4990016,78,75461,296353
5652,12/24/2021,California,State,40129160,22410,5136276,73,77485,162785,120250155,21468,6209025,0,4990016,0,75461,
5653,12/25/2021,California,State,40129160,15026,5151302,68,77553,51240,120301395,8544,6217569,0,4990016,0,75461,
5654,12/26/2021,California,State,40129160,36194,5187496,64,77617,188816,120490211,33842,6251411,0,4990016,0,75461,
5655,12/27/2021,California,State,40129160,76034,5263530,86,77703,469442,120959653,85210,6336621,86634,5076650,97,75558,1031521
5656,12/28/2021,California,State,40129160,89357,5352887,58,77761,518802,121478455,105835,6442456,20748,5097398,71,75629,200202
5657,12/29/2021,California,State,40129160,88697,5441584,80,77841,515197,121993652,109085,6551541,37673,5135071,109,75738,237451
5658,12/30/2021,California,State,40129160,86153,5527737,69,77910,500803,122494455,105298,6656839,56367,5191438,109,75847,388654
5659,12/31/2021,California,State,40129160,54724,5582461,86,77996,283496,122777951,62357,6719196,0,5191438,0,75847,
5660,1/1/2022,California,State,40129160,32986,5615447,97,78093,105196,122883147,26231,6745427,0,5191438,0,75847,
5661,1/2/2022,California,State,40129160,56747,5672194,85,78178,272456,123155603,60731,6806158,0,5191438,0,75847,
5662,1/3/2022,California,State,40129160,139985,5812179,112,78290,786646,123942249,164115,6970273,237084,5428522,77,75924,1386546
5663,1/4/2022,California,State,40129160,156620,5968799,107,78397,849838,124792087,189980,7160253,51743,5480265,130,76054,246281
5664,1/5/2022,California,State,40129160,154862,6123661,140,78537,819525,125611612,188245,7348498,50486,5530751,-5,76049,234467
5665,1/6/2022,California,State,40129160,143286,6266947,134,78671,816241,126427853,175230,7523728,103606,5634357,292,76341,528039
5666,1/7/2022,California,State,40129160,134823,6401770,129,78800,763421,127191274,168824,7692552,0,5634357,0,76341,
5667,1/8/2022,California,State,40129160,76788,6478558,147,78947,365002,127556276,93624,7786176,0,5634357,0,76341,
5668,1/9/2022,California,State,40129160,55935,6534493,127,79074,254479,127810755,65287,7851463,308820,5943177,209,76550,1759071
5669,1/10/2022,California,State,40129160,141214,6675707,155,79229,833073,128643828,177759,8029222,143380,6086557,14,76564,528351
5670,1/11/2022,California,State,40129160,134879,6810586,175,79404,834637,129478465,172019,8201241,102310,6188867,119,76683,598445
5671,1/12/2022,California,State,40129160,126429,6937015,199,79603,790996,130269461,161888,8363129,108040,6296907,121,76804,563686
5672,1/13/2022,California,State,40129160,114207,7051222,193,79796,767615,131037076,149472,8512601,119264,6416171,136,76940,665957
5673,1/14/2022,California,State,40129160,103995,7155217,190,79986,685437,131722513,137683,8650284,0,6416171,0,76940,
5674,1/15/2022,California,State,40129160,58459,7213676,219,80205,282114,132004627,73771,8724055,0,6416171,0,76940,
5675,1/16/2022,California,State,40129160,40304,7253980,225,80430,200698,132205325,48223,8772278,319809,6735980,330,77270,2070829
5676,1/17/2022,California,State,40129160,81273,7335253,217,80647,463344,132668669,105390,8877668,76374,6812354,36,77306,572433
5677,1/18/2022,California,State,40129160,119649,7454902,235,80882,871440,133540109,156775,9034443,98637,6910991,39,77345,499366
5678,1/19/2022,California,State,40129160,100973,7555875,261,81143,735469,134275578,132401,9166844,86719,6997710,176,77521,521732
5679,1/20/2022,California,State,40129160,89862,7645737,250,81393,698275,134973853,120262,9287106,125861,7123571,201,77722,658594
5680,1/21/2022,California,State,40129160,77207,7722944,266,81659,612787,135586640,106632,9393738,0,7123571,0,77722,
5681,1/22/2022,California,State,40129160,39861,7762805,250,81909,235584,135822224,54198,9447936,0,7123571,0,77722,
5682,1/23/2022,California,State,40129160,28343,7791148,273,82182,168810,135991034,36737,9484673,296072,7419643,379,78101,2089579
5683,1/24/2022,California,State,40129160,70488,7861636,227,82409,695944,136686978,100169,9584842,62826,7482469,17,78118,510331
5684,1/25/2022,California,State,40129160,60123,7921759,265,82674,628375,137315353,86153,9670995,87218,7569687,198,78316,528340
5685,1/26/2022,California,State,40129160,51912,7973671,257,82931,587539,137902892,75763,9746758,59979,7629666,255,78571,436797
5686,1/27/2022,California,State,40129160,44309,8017980,272,83203,552594,138455486,65344,9812102,76729,7706395,254,78825,446361
5687,1/28/2022,California,State,40129160,38801,8056781,261,83464,487479,138942965,59577,9871679,0,7706395,0,78825,
5688,1/29/2022,California,State,40129160,20868,8077649,285,83749,171714,139114679,31261,9902940,0,7706395,0,78825,
5689,1/30/2022,California,State,40129160,15490,8093139,281,84030,130054,139244733,20812,9923752,172226,7878621,459,79284,2122165
5690,1/31/2022,California,State,40129160,38509,8131648,272,84302,615044,139859777,59087,9982839,37147,7915768,98,79382,363026
5691,2/1/2022,California,State,40129160,32607,8164255,289,84591,522198,140381975,46963,10029802,25550,7941318,239,79621,296217
5692,2/2/2022,California,State,40129160,27275,8191530,273,84864,491614,140873589,40631,10070433,28080,7969398,181,79802,272797
5693,2/3/2022,California,State,40129160,23786,8215316,241,85105,490408,141363997,36210,10106643,37012,8006410,220,80022,504415
5694,2/4/2022,California,State,40129160,21603,8236919,279,85384,411238,141775235,33641,10140284,0,8006410,0,80022,
5695,2/5/2022,California,State,40129160,11680,8248599,243,85627,126903,141902138,17603,10157887,0,8006410,0,80022,
5696,2/6/2022,California,State,40129160,9816,8258415,215,85842,103044,142005182,12870,10170757,73361,8079771,517,80539,1543037
5697,2/7/2022,California,State,40129160,22319,8280734,224,86066,543794,142548976,34218,10204975,47310,8127081,101,80640,557732
5698,2/8/2022,California,State,40129160,17896,8298630,249,86315,467874,143016850,26619,10231594,39312,8166393,272,80912,445383
5699,2/9/2022,California,State,40129160,16175,8314805,231,86546,441504,143458354,23836,10255430,14831,8181224,162,81074,294293
5700,2/10/2022,California,State,40129160,14065,8328870,196,86742,436741,143895095,20874,10276304,22947,8204171,363,81437,442414
5701,2/11/2022,California,State,40129160,12652,8341522,207,86949,346068,144241163,18896,10295200,0,8204171,0,81437,
5702,2/12/2022,California,State,40129160,7015,8348537,181,87130,105094,144346257,10444,10305644,0,8204171,0,81437,
5703,2/13/2022,California,State,40129160,5520,8354057,180,87310,82980,144429237,7353,10312997,40158,8244329,589,82026,1178207
5704,2/14/2022,California,State,40129160,12615,8366672,172,87482,459889,144889126,18752,10331749,14697,8259026,116,82142,405623
5705,2/15/2022,California,State,40129160,10689,8377361,146,87628,431674,145320800,15150,10346899,12444,8271470,240,82382,184854
5706,2/16/2022,California,State,40129160,9279,8386640,155,87783,403833,145724633,13697,10360596,12098,8283568,207,82589,199401
5707,2/17/2022,California,State,40129160,8049,8394689,172,87955,394419,146119052,11838,10372434,12577,8296145,284,82873,384398
5708,2/18/2022,California,State,40129160,7008,8401697,144,88099,303518,146422570,10811,10383245,0,8296145,0,82873,
5709,2/19/2022,California,State,40129160,4188,8405885,110,88209,85908,146508478,5998,10389243,0,8296145,0,82873,
5710,2/20/2022,California,State,40129160,3599,8409484,143,88352,73011,146581489,4818,10394061,0,8296145,0,82873,
5711,2/21/2022,California,State,40129160,5287,8414771,123,88475,175312,146756801,7595,10401656,40585,8336730,650,83523,1446277
5712,2/22/2022,California,State,40129160,7062,8421833,117,88592,480591,147237392,10968,10412624,6483,8343213,46,83569,133083
5713,2/23/2022,California,State,40129160,5544,8427377,121,88713,386645,147624037,8302,10420926,6754,8349967,215,83784,138217
5714,2/24/2022,California,State,40129160,5114,8432491,89,88802,369363,147993400,7579,10428505,11737,8361704,208,83992,393509
5715,2/25/2022,California,State,40129160,4735,8437226,107,88909,315382,148308782,7028,10435533,0,8361704,0,83992,
5716,2/26/2022,California,State,40129160,2670,8439896,88,88997,82833,148391615,3830,10439363,0,8361704,0,83992,
5717,2/27/2022,California,State,40129160,2386,8442282,77,89074,73793,148465408,3055,10442418,19492,8381196,708,84700,1107545
5718,2/28/2022,California,State,40129160,5166,8447448,86,89160,408485,148873893,7502,10449920,1460,8382656,12,84712,65553
5719,3/1/2022,California,State,40129160,4634,8452082,87,89247,363117,149237010,6385,10456305,6027,8388683,216,84928,86751
5720,3/2/2022,California,State,40129160,3922,8456004,67,89314,339109,149576119,5613,10461918,5240,8393923,199,85127,468441
5721,3/3/2022,California,State,40129160,3545,8459549,88,89402,334462,149910581,5093,10467011,5754,8399677,226,85353,346473
5722,3/4/2022,California,State,40129160,3093,8462642,60,89462,277020,150187601,4663,10471674,0,8399677,0,85353,
5723,3/5/2022,California,State,40129160,2108,8464750,68,89530,73289,150260890,2641,10474315,0,8399677,0,85353,
5724,3/6/2022,California,State,40129160,1811,8466561,64,89594,65176,150326066,2267,10476582,12634,8412311,496,85849,
5725,3/7/2022,California,State,40129160,3848,8470409,60,89654,379681,150705747,5603,10482185,2358,8414669,5,85854,1059257
5726,3/8/2022,California,State,40129160,3283,8473692,60,89714,343798,151049545,4541,10486726,4985,8419654,171,86025,286512
5727,3/9/2022,California,State,40129160,2980,8476672,59,89773,327488,151377033,4217,10490943,3221,8422875,160,86185,148711
5728,3/10/2022,California,State,40129160,2523,8479195,62,89835,313956,151690989,3703,10494646,3825,8426700,202,86387,190136
5729,3/11/2022,California,State,40129160,2273,8481468,56,89891,264240,151955229,3457,10498103,0,8426700,0,86387,
5730,3/12/2022,California,State,40129160,1486,8482954,43,89934,69820,152025049,2039,10500142,0,8426700,0,86387,
5731,3/13/2022,California,State,40129160,1276,8484230,42,89976,63564,152088613,1594,10501736,11628,8438328,407,86794,1074656
5732,3/14/2022,California,State,40129160,2866,8487096,37,90013,360716,152449329,3990,10505726,727,8439055,-2,86792,60478
5733,3/15/2022,California,State,40129160,2618,8489714,34,90047,333583,152782912,3581,10509307,3482,8442537,135,86927,291159
5734,3/16/2022,California,State,40129160,2459,8492173,33,90080,316878,153099790,3479,10512786,2931,8445468,118,87045,148255
5735,3/17/2022,California,State,40129160,2297,8494470,46,90126,295793,153395583,3167,10515953,4541,8450009,149,87194,281849
5736,3/18/2022,California,State,40129160,1997,8496467,35,90161,254664,153650247,2806,10518759,0,8450009,0,87194,
5737,3/19/2022,California,State,40129160,1246,8497713,25,90186,64740,153714987,1622,10520381,0,8450009,0,87194,
5738,3/20/2022,California,State,40129160,1299,8499012,37,90223,58061,153773048,1456,10521837,15349,8465358,291,87485,919458
5739,3/21/2022,California,State,40129160,2696,8501708,39,90262,335575,154108623,3649,10525486,662,8466020,13,87498,48739
5740,3/22/2022,California,State,40129160,3014,8504722,27,90289,293557,154402180,3861,10529347,5100,8471120,92,87590,286113
5741,3/23/2022,California,State,40129160,2244,8506966,24,90313,284121,154686301,3061,10532408,2250,8473370,112,87702,143082
5742,3/24/2022,California,State,40129160,2294,8509260,18,90331,279573,154965874,3080,10535488,3029,8476399,107,87809,279128
5743,3/25/2022,California,State,40129160,1995,8511255,36,90367,237228,155203102,2794,10538282,0,8476399,0,87809,
5744,3/26/2022,California,State,40129160,1442,8512697,25,90392,65161,155268263,1782,10540064,0,8476399,0,87809,
5745,3/27/2022,California,State,40129160,1559,8514256,21,90413,60575,155328838,1693,10541757,7169,8483568,145,87954,831124
5746,3/28/2022,California,State,40129160,2886,8517142,24,90437,250658,155579496,3663,10545420,741,8484309,2,87956,50093
5747,3/29/2022,California,State,40129160,2711,8519853,22,90459,316151,155895647,3539,10548959,2761,8487070,87,88043,270341
5748,3/30/2022,California,State,40129160,2639,8522492,21,90480,295876,156191523,3453,10552412,2909,8489979,72,88115,148289
5749,3/31/2022,California,State,40129160,2443,8524935,22,90502,259358,156450881,3222,10555634,4026,8494005,92,88207,215235
5750,4/1/2022,California,State,40129160,2628,8527563,17,90519,244054,156694935,3233,10558867,0,8494005,0,88207,
5751,4/2/2022,California,State,40129160,1726,8529289,20,90539,60139,156755074,1917,10560784,0,8494005,0,88207,
5752,4/3/2022,California,State,40129160,1765,8531054,16,90555,53342,156808416,1850,10562634,0,8494005,0,88207,
5753,4/4/2022,California,State,40129160,3788,8534842,21,90576,302938,157111354,4522,10567156,9925,8503930,148,88355,688448
5754,4/5/2022,California,State,40129160,3354,8538196,24,90600,262969,157374323,4079,10571235,0,8503930,0,88355,
5755,4/6/2022,California,State,40129160,3398,8541594,25,90625,261668,157635991,4119,10575354,0,8503930,0,88355,
5756,4/7/2022,California,State,40129160,3060,8544654,18,90643,256718,157892709,3896,10579250,9841,8513771,202,88557,979789
5757,4/8/2022,California,State,40129160,2962,8547616,17,90660,226104,158118813,3710,10582960,0,8513771,0,88557,
5758,4/9/2022,California,State,40129160,2062,8549678,9,90669,58976,158177789,2285,10585245,0,8513771,0,88557,
5759,4/10/2022,California,State,40129160,2217,8551895,10,90679,54258,158232047,2085,10587330,0,8513771,0,88557,
5760,4/11/2022,California,State,40129160,4443,8556338,21,90700,228608,158460655,5035,10592365,0,8513771,0,88557,
5761,4/12/2022,California,State,40129160,4097,8560435,13,90713,205119,158665774,4650,10597015,15562,8529333,191,88748,
5762,4/13/2022,California,State,40129160,3999,8564434,15,90728,189462,158855236,4786,10601801,0,8529333,0,88748,870005
5763,4/14/2022,California,State,40129160,3736,8568170,17,90745,171351,159026587,4601,10606402,7610,8536943,159,88907,369259
5764,4/15/2022,California,State,40129160,3631,8571801,20,90765,145039,159171626,4448,10610850,0,8536943,0,88907,
5765,4/16/2022,California,State,40129160,2685,8574486,14,90779,59089,159230715,3005,10613855,0,8536943,0,88907,
5766,4/17/2022,California,State,40129160,2372,8576858,15,90794,39107,159269822,1857,10615712,0,8536943,0,88907,
5767,4/18/2022,California,State,40129160,6292,8583150,16,90810,328465,159598287,7321,10623033,13714,8550657,147,89054,710598
5768,4/19/2022,California,State,40129160,5866,8589016,10,90820,300378,159898665,6710,10629743,0,8550657,0,89054,
5769,4/20/2022,California,State,40129160,5648,8594664,15,90835,294004,160192669,6628,10636371,0,8550657,0,89054,
5770,4/21/2022,California,State,40129160,5499,8600163,11,90846,287847,160480516,6559,10642930,15747,8566404,201,89255,593442
5771,4/22/2022,California,State,40129160,5124,8605287,10,90856,257084,160737600,6466,10649396,0,8566404,0,89255,
5772,4/23/2022,California,State,40129160,3622,8608909,12,90868,62880,160800480,4090,10653486,0,8566404,0,89255,
5773,4/24/2022,California,State,40129160,3617,8612526,17,90885,56707,160857187,3603,10657089,0,8566404,0,89255,
5774,4/25/2022,California,State,40129160,7837,8620363,17,90902,370264,161227451,9158,10666247,21388,8587792,136,89391,778304
5775,4/26/2022,California,State,40129160,7527,8627890,9,90911,328399,161555850,8666,10674913,0,8587792,0,89391,
5776,4/27/2022,California,State,40129160,7426,8635316,12,90923,320756,161876606,8958,10683871,0,8587792,0,89391,
5777,4/28/2022,California,State,40129160,6999,8642315,10,90933,307841,162184447,8441,10692312,17871,8605663,191,89582,863126
5778,4/29/2022,California,State,40129160,6520,8648835,14,90947,266135,162450582,8018,10700330,0,8605663,0,89582,
5779,4/30/2022,California,State,40129160,4810,8653645,15,90962,65230,162515812,5429,10705759,0,8605663,0,89582,
5780,5/1/2022,California,State,40129160,5211,8658856,10,90972,57160,162572972,4705,10710464,0,8605663,0,89582,
5781,5/2/2022,California,State,40129160,10381,8669237,11,90983,362976,162935948,11966,10722430,26000,8631663,112,89694,836981
5782,5/3/2022,California,State,40129160,9955,8679192,10,90993,335492,163271440,11533,10733963,0,8631663,0,89694,
5783,5/4/2022,California,State,40129160,9800,8688992,13,91006,330524,163601964,11609,10745572,0,8631663,0,89694,
5784,5/5/2022,California,State,40129160,9357,8698349,6,91012,321130,163923094,10962,10756534,22757,8654420,157,89851,881851
5785,5/6/2022,California,State,40129160,8928,8707277,13,91025,281216,164204310,10766,10767300,0,8654420,0,89851,
5786,5/7/2022,California,State,40129160,6312,8713589,10,91035,71086,164275396,6908,10774208,0,8654420,0,89851,
5787,5/8/2022,California,State,40129160,6094,8719683,18,91053,58343,164333739,5804,10780012,0,8654420,0,89851,
5788,5/9/2022,California,State,40129160,12854,8732537,12,91065,380315,164714054,15075,10795087,33206,8687626,106,89957,895351
5789,5/10/2022,California,State,40129160,11990,8744527,21,91086,344319,165058373,14375,10809462,0,8687626,0,89957,
5790,5/11/2022,California,State,40129160,11928,8756455,10,91096,344871,165403244,14435,10823897,0,8687626,0,89957,
5791,5/12/2022,California,State,40129160,11546,8768001,10,91106,330892,165734136,13963,10837860,19701,8707327,160,90117,720066
5792,5/13/2022,California,State,40129160,11451,8779452,21,91127,296997,166031133,13796,10851656,0,8707327,0,90117,
5793,5/14/2022,California,State,40129160,8020,8787472,17,91144,74734,166105867,8549,10860205,0,8707327,0,90117,
5794,5/15/2022,California,State,40129160,7910,8795382,26,91170,66138,166172005,7686,10867891,0,8707327,0,90117,
5795,5/16/2022,California,State,40129160,17370,8812752,11,91181,389672,166561677,20490,10888381,50544,8757871,102,90219,1082203
5796,5/17/2022,California,State,40129160,16223,8828975,15,91196,351680,166913357,18839,10907220,0,8757871,0,90219,
5797,5/18/2022,California,State,40129160,15797,8844772,17,91213,348129,167261486,19032,10926252,0,8757871,0,90219,
5798,5/19/2022,California,State,40129160,14632,8859404,17,91230,334488,167595974,17930,10944182,40019,8797890,163,90382,940973
5799,5/20/2022,California,State,40129160,13955,8873359,17,91247,299881,167895855,17426,10961608,0,8797890,0,90382,
5800,5/21/2022,California,State,40129160,8991,8882350,21,91268,77276,167973131,10251,10971859,0,8797890,0,90382,
5801,5/22/2022,California,State,40129160,8705,8891055,15,91283,69366,168042497,9193,10981052,0,8797890,0,90382,
5802,5/23/2022,California,State,40129160,19466,8910521,13,91296,396282,168438779,23312,11004364,55608,8853498,106,90488,880441
5803,5/24/2022,California,State,40129160,18135,8928656,27,91323,354680,168793459,21558,11025922,0,8853498,0,90488,
5804,5/25/2022,California,State,40129160,17138,8945794,20,91343,342984,169136443,21154,11047076,0,8853498,0,90488,
5805,5/26/2022,California,State,40129160,15517,8961311,13,91356,324530,169460973,19540,11066616,42676,8896174,124,90612,1006527
5806,5/27/2022,California,State,40129160,14170,8975481,18,91374,268762,169729735,18243,11084859,0,8896174,0,90612,
5807,5/28/2022,California,State,40129160,8897,8984378,20,91394,71446,169801181,10221,11095080,0,8896174,0,90612,
5808,5/29/2022,California,State,40129160,7901,8992279,26,91420,60208,169861389,8532,11103612,0,8896174,0,90612,
5809,5/30/2022,California,State,40129160,8639,9000918,20,91440,82763,169944152,8272,11111884,59488,8955662,107,90719,892407
5810,5/31/2022,California,State,40129160,23936,9024854,14,91454,454832,170398984,30466,11142350,0,8955662,0,90719,-240721
5811,6/1/2022,California,State,40129160,20713,9045567,19,91473,364331,170763315,24110,11166460,0,8955662,0,90719,
5812,6/2/2022,California,State,40129160,18067,9063634,22,91495,336570,171099885,22241,11188701,33617,8989279,96,90815,736677
5813,6/3/2022,California,State,40129160,16416,9080050,20,91515,297496,171397381,20590,11209291,0,8989279,0,90815,
5814,6/4/2022,California,State,40129160,10647,9090697,18,91533,82532,171479913,12260,11221551,0,8989279,0,90815,
5815,6/5/2022,California,State,40129160,9691,9100388,19,91552,68644,171548557,10353,11231904,0,8989279,0,90815,
5816,6/6/2022,California,State,40129160,21064,9121452,24,91576,340628,171889185,25761,11257665,69623,9058902,77,90892,861779
5817,6/7/2022,California,State,40129160,18859,9140311,20,91596,306951,172196136,23126,11280791,0,9058902,0,90892,
5818,6/8/2022,California,State,40129160,17721,9158032,22,91618,284740,172480876,22391,11303182,0,9058902,0,90892,
5819,6/9/2022,California,State,40129160,15855,9173887,28,91646,250485,172731361,20104,11323286,47129,9106031,114,91006,969129
5820,6/10/2022,California,State,40129160,15380,9189267,29,91675,209085,172940446,19650,11342936,0,9106031,0,91006,
5821,6/11/2022,California,State,40129160,9892,9199159,29,91704,75214,173015660,11451,11354387,0,9106031,0,91006,
5822,6/12/2022,California,State,40129160,8916,9208075,27,91731,63648,173079308,9423,11363810,0,9106031,0,91006,
5823,6/13/2022,California,State,40129160,18518,9226593,16,91747,221354,173300662,22787,11386597,63308,9169339,101,91107,762273
5824,6/14/2022,California,State,40129160,16891,9243484,21,91768,206489,173507151,20782,11407379,0,9169339,0,91107,
5825,6/15/2022,California,State,40129160,16342,9259826,27,91795,180614,173687765,20142,11427521,0,9169339,0,91107,
5826,6/16/2022,California,State,40129160,15294,9275120,31,91826,174916,173862681,18899,11446420,30603,9199942,133,91240,705510
5827,6/17/2022,California,State,40129160,14854,9289974,38,91864,154765,174017446,18815,11465235,0,9199942,0,91240,
5828,6/18/2022,California,State,40129160,10314,9300288,30,91894,73109,174090555,11882,11477117,0,9199942,0,91240,
5829,6/19/2022,California,State,40129160,9325,9309613,30,91924,59076,174149631,9979,11487096,0,9199942,0,91240,
5830,6/20/2022,California,State,40129160,18261,9327874,29,91953,182417,174332048,21940,11509036,65026,9264968,74,91314,552693
5831,6/21/2022,California,State,40129160,19406,9347280,29,91982,211428,174543476,24028,11533064,0,9264968,0,91314,
5832,6/22/2022,California,State,40129160,17810,9365090,37,92019,176142,174719618,21370,11554434,0,9264968,0,91314,
5833,6/23/2022,California,State,40129160,17130,9382220,34,92053,171762,174891380,21456,11575890,47886,9312854,106,91420,495057
5834,6/24/2022,California,State,40129160,16305,9398525,34,92087,149542,175040922,20302,11596192,0,9312854,0,91420,
5835,6/25/2022,California,State,40129160,11596,9410121,21,92108,72765,175113687,13511,11609703,0,9312854,0,91420,
5836,6/26/2022,California,State,40129160,10788,9420909,29,92137,61867,175175554,11483,11621186,0,9312854,0,91420,
5837,6/27/2022,California,State,40129160,22562,9443471,26,92163,206205,175381759,27458,11648644,65339,9378193,96,91516,525804
5838,6/28/2022,California,State,40129160,21037,9464508,29,92192,190951,175572710,25514,11674158,0,9378193,0,91516,
5839,6/29/2022,California,State,40129160,19773,9484281,30,92222,169858,175742568,24597,11698755,0,9378193,0,91516,
5840,6/30/2022,California,State,40129160,18119,9502400,35,92257,165928,175908496,22877,11721632,53106,9431299,185,91701,512382
5841,7/1/2022,California,State,40129160,17895,9520295,36,92293,136487,176044983,21893,11743525,0,9431299,0,91701,
5842,7/2/2022,California,State,40129160,11410,9531705,47,92340,65895,176110878,13325,11756850,0,9431299,0,91701,
5843,7/3/2022,California,State,40129160,9799,9541504,44,92384,51192,176162070,10357,11767207,0,9431299,0,91701,
5844,7/4/2022,California,State,40129160,9976,9551480,42,92426,58736,176220806,8642,11775849,69077,9500376,94,91795,492468
5845,7/5/2022,California,State,40129160,27072,9578552,32,92458,237994,176458800,33796,11809645,0,9500376,0,91795,
5846,7/6/2022,California,State,40129160,22956,9601508,41,92499,183980,176642780,28031,11837676,0,9500376,0,91795,
5847,7/7/2022,California,State,40129160,21099,9622607,30,92529,171569,176814349,26292,11863968,39818,9540194,135,91930,380639
5848,7/8/2022,California,State,40129160,20107,9642714,53,92582,154974,176969323,25019,11888987,0,9540194,0,91930,
5849,7/9/2022,California,State,40129160,13410,9656124,44,92626,73000,177042323,15680,11904667,0,9540194,0,91930,
5850,7/10/2022,California,State,40129160,11623,9667747,37,92663,60278,177102601,12866,11917533,0,9540194,0,91930,
5851,7/11/2022,California,State,40129160,24392,9692139,38,92701,202753,177305354,30404,11947937,79204,9619398,125,92055,520990
5852,7/12/2022,California,State,40129160,22366,9714505,47,92748,187805,177493159,27713,11975650,0,9619398,0,92055,
5853,7/13/2022,California,State,40129160,21143,9735648,31,92779,168217,177661376,25917,12001567,0,9619398,0,92055,
5854,7/14/2022,California,State,40129160,19862,9755510,37,92816,161939,177823315,24346,12025913,58429,9677827,130,92185,513333
5855,7/15/2022,California,State,40129160,18745,9774255,38,92854,144433,177967748,24019,12049932,0,9677827,0,92185,
5856,7/16/2022,California,State,40129160,12854,9787109,37,92891,72490,178040238,15276,12065208,0,9677827,0,92185,
5857,7/17/2022,California,State,40129160,10987,9798096,48,92939,59957,178100195,12457,12077665,0,9677827,0,92185,
5858,7/18/2022,California,State,40129160,23384,9821480,41,92980,200560,178300755,29254,12106919,74682,9752509,107,92292,456420
5859,7/19/2022,California,State,40129160,21100,9842580,50,93030,185611,178486366,25884,12132803,0,9752509,0,92292,
5860,7/20/2022,California,State,40129160,19395,9861975,63,93093,164631,178650997,24288,12157091,0,9752509,0,92292,
5861,7/21/2022,California,State,40129160,17641,9879616,37,93130,154900,178805897,22170,12179261,52294,9804803,177,92469,483485
5862,7/22/2022,California,State,40129160,17108,9896724,47,93177,136983,178942880,22008,12201269,0,9804803,0,92469,
5863,7/23/2022,California,State,40129160,11292,9908016,35,93212,67417,179010297,13566,12214835,0,9804803,0,92469,
5864,7/24/2022,California,State,40129160,9847,9917863,45,93257,56287,179066584,11097,12225932,0,9804803,0,92469,
5865,7/25/2022,California,State,40129160,21240,9939103,67,93324,186362,179252946,26762,12252694,67127,9871930,126,92595,501515
5866,7/26/2022,California,State,40129160,18544,9957647,53,93377,170961,179423907,23119,12275813,0,9871930,0,92595,
5867,7/27/2022,California,State,40129160,16613,9974260,55,93432,152902,179576809,21045,12296858,0,9871930,0,92595,
5868,7/28/2022,California,State,40129160,15013,9989273,54,93486,143047,179719856,18920,12315778,50788,9922718,168,92763,421340
5869,7/29/2022,California,State,40129160,13844,10003117,40,93526,125318,179845174,18416,12334194,0,9922718,0,92763,
5870,7/30/2022,California,State,40129160,9241,10012358,51,93577,60905,179906079,11465,12345659,0,9922718,0,92763,
5871,7/31/2022,California,State,40129160,8196,10020554,46,93623,51484,179957563,9485,12355144,0,9922718,0,92763,
5872,8/1/2022,California,State,40129160,17604,10038158,46,93669,172946,180130509,21429,12376573,60652,9983370,126,92889,513186
5873,8/2/2022,California,State,40129160,15261,10053419,40,93709,158923,180289432,18718,12395291,0,9983370,0,92889,
5874,8/3/2022,California,State,40129160,13683,10067102,47,93756,140886,180430318,17107,12412398,0,9983370,0,92889,
5875,8/4/2022,California,State,40129160,12233,10079335,44,93800,130070,180560388,15409,12427807,40956,10024326,167,93056,432061
5876,8/5/2022,California,State,40129160,11606,10090941,60,93860,118571,180678959,15107,12442914,0,10024326,0,93056,
5877,8/6/2022,California,State,40129160,7946,10098887,38,93898,55369,180734328,9449,12452363,0,10024326,0,93056,
5878,8/7/2022,California,State,40129160,7144,10106031,32,93930,47772,180782100,7983,12460346,0,10024326,0,93056,
5879,8/8/2022,California,State,40129160,14490,10120521,44,93974,166795,180948895,18183,12478529,47632,10071958,137,93193,412846
5880,8/9/2022,California,State,40129160,12273,10132794,43,94017,150275,181099170,15596,12494125,0,10071958,0,93193,
5881,8/10/2022,California,State,40129160,11306,10144100,41,94058,132976,181232146,14702,12508827,0,10071958,0,93193,
5882,8/11/2022,California,State,40129160,10293,10154393,37,94095,131796,181363942,13247,12522074,32803,10104761,185,93378,372359
5883,8/12/2022,California,State,40129160,9578,10163971,52,94147,113979,181477921,12462,12534536,0,10104761,0,93378,
5884,8/13/2022,California,State,40129160,6555,10170526,26,94173,51691,181529612,8080,12542616,0,10104761,0,93378,
5885,8/14/2022,California,State,40129160,6138,10176664,47,94220,46099,181575711,7036,12549652,0,10104761,0,93378,
5886,8/15/2022,California,State,40129160,11947,10188611,34,94254,162278,181737989,14947,12564599,41376,10146137,139,93517,392034
5887,8/16/2022,California,State,40129160,10937,10199548,42,94296,146442,181884431,13528,12578127,0,10146137,0,93517,
5888,8/17/2022,California,State,40129160,9842,10209390,35,94331,128138,182012569,12227,12590354,0,10146137,0,93517,
5889,8/18/2022,California,State,40129160,9013,10218403,36,94367,125895,182138464,11381,12601735,29480,10175617,187,93704,442365
5890,8/19/2022,California,State,40129160,8331,10226734,37,94404,110635,182249099,10831,12612566,0,10175617,0,93704,
5891,8/20/2022,California,State,40129160,6016,10232750,41,94445,51065,182300164,7047,12619613,0,10175617,0,93704,
5892,8/21/2022,California,State,40129160,5387,10238137,31,94476,45482,182345646,6038,12625651,0,10175617,0,93704,
5893,8/22/2022,California,State,40129160,10987,10249124,40,94516,164243,182509889,13852,12639503,36272,10211889,139,93843,388932
5894,8/23/2022,California,State,40129160,9455,10258579,26,94542,147566,182657455,11861,12651364,0,10211889,0,93843,
5895,8/24/2022,California,State,40129160,8416,10266995,33,94575,129018,182786473,10716,12662080,0,10211889,0,93843,
5896,8/25/2022,California,State,40129160,7571,10274566,31,94606,120916,182907389,9486,12671566,26003,10237892,204,94047,387658
5897,8/26/2022,California,State,40129160,7274,10281840,41,94647,110527,183017916,9367,12680933,0,10237892,0,94047,
5898,8/27/2022,California,State,40129160,4760,10286600,18,94665,49709,183067625,5974,12686907,0,10237892,0,94047,
5899,8/28/2022,California,State,40129160,4442,10291042,33,94698,44154,183111779,5096,12692003,0,10237892,0,94047,
5900,8/29/2022,California,State,40129160,8928,10299970,28,94726,158340,183270119,11372,12703375,30245,10268137,73,94120,411317
5901,8/30/2022,California,State,40129160,7625,10307595,37,94763,147086,183417205,9670,12713045,0,10268137,0,94120,
5902,8/31/2022,California,State,40129160,6823,10314418,38,94801,126547,183543752,8771,12721816,0,10268137,0,94120,
5903,9/1/2022,California,State,40129160,6190,10320608,22,94823,117486,183661238,7727,12729543,23149,10291286,119,94239,382534
5904,9/2/2022,California,State,40129160,5410,10326018,38,94861,96689,183757927,7018,12736561,0,10291286,0,94239,
5905,9/3/2022,California,State,40129160,3528,10329546,32,94893,42427,183800354,4332,12740893,0,10291286,0,94239,
5906,9/4/2022,California,State,40129160,3151,10332697,30,94923,38238,183838592,3756,12744649,0,10291286,0,94239,
5907,9/5/2022,California,State,40129160,3305,10336002,28,94951,52429,183891021,3426,12748075,23431,10314717,112,94351,346017
5908,9/6/2022,California,State,40129160,7748,10343750,30,94981,177294,184068315,10158,12758233,0,10314717,0,94351,
5909,9/7/2022,California,State,40129160,5919,10349669,32,95013,125111,184193426,7403,12765636,0,10314717,0,94351,
5910,9/8/2022,California,State,40129160,5254,10354923,22,95035,116533,184309959,6414,12772050,15278,10329995,207,94558,282761
5911,9/9/2022,California,State,40129160,4802,10359725,35,95070,99634,184409593,5856,12777906,0,10329995,0,94558,
5912,9/10/2022,California,State,40129160,3252,10362977,30,95100,44117,184453710,3795,12781701,0,10329995,0,94558,
5913,9/11/2022,California,State,40129160,3034,10366011,23,95123,40015,184493725,3304,12785005,0,10329995,0,94558,
5914,9/12/2022,California,State,40129160,5658,10371669,30,95153,142023,184635748,7042,12792047,0,10329995,0,94558,
5915,9/13/2022,California,State,40129160,4938,10376607,21,95174,133934,184769682,6086,12798133,24904,10354899,189,94747,516536
5916,9/14/2022,California,State,40129160,4382,10380989,22,95196,114936,184884618,5504,12803637,0,10354899,0,94747,
5917,9/15/2022,California,State,40129160,3997,10384986,26,95222,114064,184998682,5055,12808692,0,10354899,0,94747,
5918,9/16/2022,California,State,40129160,3773,10388759,22,95244,95168,185093850,4798,12813490,0,10354899,0,94747,
5919,9/17/2022,California,State,40129160,2747,10391506,22,95266,45460,185139310,3142,12816632,0,10354899,0,94747,
5920,9/18/2022,California,State,40129160,2475,10393981,30,95296,40975,185180285,2694,12819326,0,10354899,0,94747,
5921,9/19/2022,California,State,40129160,4767,10398748,20,95316,135966,185316251,5976,12825302,0,10354899,0,94747,
5922,9/20/2022,California,State,40129160,4225,10402973,25,95341,127680,185443931,5313,12830615,29774,10384673,262,95009,675865
5923,9/21/2022,California,State,40129160,3800,10406773,23,95364,107818,185551749,4790,12835405,0,10384673,0,95009,
5924,9/22/2022,California,State,40129160,3654,10410427,12,95376,104166,185655915,4477,12839882,0,10384673,0,95009,
5925,9/23/2022,California,State,40129160,3443,10413870,26,95402,88732,185744647,4361,12844243,0,10384673,0,95009,
5926,9/24/2022,California,State,40129160,2557,10416427,17,95419,39508,185784155,2898,12847141,0,10384673,0,95009,
5927,9/25/2022,California,State,40129160,2346,10418773,28,95447,35877,185820032,2540,12849681,0,10384673,0,95009,
5928,9/26/2022,California,State,40129160,4604,10423377,20,95467,125899,185945931,5620,12855301,0,10384673,0,95009,
5929,9/27/2022,California,State,40129160,3956,10427333,20,95487,118698,186064629,4785,12860086,27679,10412352,156,95165,676399
5930,9/28/2022,California,State,40129160,3830,10431163,15,95502,99540,186164169,4689,12864775,0,10412352,0,95165,
5931,9/29/2022,California,State,40129160,3347,10434510,17,95519,94010,186258179,4225,12869000,0,10412352,0,95165,
5932,9/30/2022,California,State,40129160,3139,10437649,8,95527,81181,186339360,4000,12873000,0,10412352,0,95165,
5933,10/1/2022,California,State,40129160,2352,10440001,11,95538,36094,186375454,2593,12875593,0,10412352,0,95165,
5934,10/2/2022,California,State,40129160,1964,10441965,16,95554,32905,186408359,2258,12877851,0,10412352,0,95165,
5935,10/3/2022,California,State,40129160,3849,10445814,14,95568,112258,186520617,4817,12882668,0,10412352,0,95165,
5936,10/4/2022,California,State,40129160,3337,10449151,13,95581,102216,186622833,4190,12886858,25111,10437463,249,95414,625195
5937,10/5/2022,California,State,40129160,3008,10452159,7,95588,84913,186707746,3813,12890671,0,10437463,0,95414,
5938,10/6/2022,California,State,40129160,2770,10454929,8,95596,83934,186791680,3462,12894133,0,10437463,0,95414,
5939,10/7/2022,California,State,40129160,2634,10457563,3,95599,75052,186866732,3476,12897609,0,10437463,0,95414,
5940,10/8/2022,California,State,40129160,1912,10459475,6,95605,35972,186902704,2349,12899958,0,10437463,0,95414,
5941,10/9/2022,California,State,40129160,1655,10461130,0,95605,33073,186935777,1993,12901951,0,10437463,0,95414,
5942,10/10/2022,California,State,40129160,3134,10464264,2,95607,97510,187033287,3818,12905769,0,10437463,0,95414,
5943,10/11/2022,California,State,40129160,2944,10467208,2,95609,98796,187132083,3691,12909460,21329,10458792,190,95604,562782
5944,10/12/2022,California,State,40129160,2631,10469839,0,95609,82201,187214284,3448,12912908,0,10458792,0,95604,
5945,10/13/2022,California,State,40129160,2241,10472080,3,95612,70892,187285176,3030,12915938,0,10458792,0,95604,
5946,10/14/2022,California,State,40129160,1670,10473750,0,95612,52090,187337266,2363,12918301,0,10458792,0,95604,
5947,10/15/2022,California,State,40129160,1088,10474838,1,95613,23170,187360436,1425,12919726,0,10458792,0,95604,
5948,10/16/2022,California,State,40129160,815,10475653,1,95614,17252,187377688,995,12920721,0,10458792,0,95604,
5949,10/17/2022,California,State,40129160,748,10476401,0,95614,15433,187393121,842,12921563,0,10458792,0,95604,
5950,10/18/2022,California,State,40129160,0,10476401,0,95614,,187393121,,12921563,18150,10476942,204,95808,530134
5951,10/19/2022,California,State,40129160,541,10476942,194,95808,123351,187516472,9325,12930888,0,10476942,0,95808,
