,county,administered_date,total_doses,cumulative_total_doses,pfizer_doses,cumulative_pfizer_doses,moderna_doses,cumulative_moderna_doses,jj_doses,cumulative_jj_doses,partially_vaccinated,total_partially_vaccinated,fully_vaccinated,cumulative_fully_vaccinated,at_least_one_dose,cumulative_at_least_one_dose,california_flag,booster_recip_count,cumulative_booster_recip_count,booster_eligible_population
66,All CA Counties,2020-01-05,1,1,1,1,0,0,0,0,1,1,0,0,1,1,,0,0,28671193
67,All CA Counties,2020-07-27,5,6,2,3,3,3,0,0,5,6,0,0,5,6,,0,0,28671193
68,All CA Counties,2020-07-28,6,12,1,4,5,8,0,0,6,12,0,0,6,12,,0,0,28671193
69,All CA Counties,2020-07-29,9,21,0,4,9,17,0,0,9,21,0,0,9,21,,0,0,28671193
70,All CA Counties,2020-07-30,13,34,5,9,8,25,0,0,13,34,0,0,13,34,,0,0,28671193
71,All CA Counties,2020-07-31,6,40,2,11,4,29,0,0,6,40,0,0,6,40,,0,0,28671193
72,All CA Counties,2020-08-01,15,55,6,17,9,38,0,0,15,55,0,0,15,55,,0,0,28671193
73,All CA Counties,2020-08-02,5,60,3,20,2,40,0,0,5,60,0,0,5,60,,0,0,28671193
74,All CA Counties,2020-08-03,16,76,1,21,15,55,0,0,16,76,0,0,16,76,,0,0,28671193
75,All CA Counties,2020-08-04,20,96,6,27,14,69,0,0,20,96,0,0,20,96,,0,0,28671193
76,All CA Counties,2020-08-05,19,115,6,33,13,82,0,0,19,115,0,0,19,115,,0,0,28671193
77,All CA Counties,2020-08-06,19,134,6,39,13,95,0,0,19,134,0,0,19,134,,0,0,28671193
78,All CA Counties,2020-08-07,15,149,5,44,10,105,0,0,15,149,0,0,15,149,,0,0,28671193
79,All CA Counties,2020-08-08,6,155,4,48,2,107,0,0,6,155,0,0,6,155,,0,0,28671193
80,All CA Counties,2020-08-09,4,159,1,49,3,110,0,0,4,159,0,0,4,159,,0,0,28671193
81,All CA Counties,2020-08-10,35,194,17,66,18,128,0,0,34,193,0,0,34,193,,0,0,28671193
82,All CA Counties,2020-08-11,31,225,13,79,18,146,0,0,31,224,0,0,31,224,,0,0,28671193
83,All CA Counties,2020-08-12,33,258,23,102,10,156,0,0,33,257,0,0,33,257,,0,0,28671193
84,All CA Counties,2020-08-13,37,295,18,120,19,175,0,0,37,294,0,0,37,294,,0,0,28671193
85,All CA Counties,2020-08-14,26,321,9,129,17,192,0,0,26,320,0,0,26,320,,0,0,28671193
86,All CA Counties,2020-08-15,3,324,2,131,1,193,0,0,3,323,0,0,3,323,,0,0,28671193
87,All CA Counties,2020-08-16,4,328,4,135,0,193,0,0,4,327,0,0,4,327,,0,0,28671193
88,All CA Counties,2020-08-17,36,364,19,154,17,210,0,0,36,363,0,0,36,363,,0,0,28671193
89,All CA Counties,2020-08-18,24,388,12,166,12,222,0,0,24,387,0,0,24,387,,0,0,28671193
90,All CA Counties,2020-08-19,40,428,26,192,14,236,0,0,39,425,1,1,39,426,,0,0,28671193
91,All CA Counties,2020-08-20,47,475,31,223,16,252,0,0,47,472,0,1,47,473,,0,0,28671193
92,All CA Counties,2020-08-21,49,524,25,248,24,276,0,0,47,518,1,2,47,520,,0,0,28671193
93,All CA Counties,2020-08-22,16,540,11,259,5,281,0,0,16,534,0,2,16,536,,0,0,28671193
94,All CA Counties,2020-08-23,10,550,8,267,2,283,0,0,8,540,2,4,8,544,,0,0,28671193
95,All CA Counties,2020-08-24,50,600,32,299,18,301,0,0,47,584,3,7,47,591,,0,0,28671193
96,All CA Counties,2020-08-25,51,651,36,335,15,316,0,0,47,627,4,11,47,638,,0,0,28671193
97,All CA Counties,2020-08-26,72,723,45,380,27,343,0,0,62,679,10,21,62,700,,0,0,28671193
98,All CA Counties,2020-08-27,68,791,49,429,19,362,0,0,58,727,10,31,58,758,,0,0,28671193
99,All CA Counties,2020-08-28,70,861,44,473,26,388,0,0,57,771,13,44,57,815,,0,0,28671193
100,All CA Counties,2020-08-29,15,876,8,481,7,395,0,0,14,784,1,45,14,829,,0,0,28671193
101,All CA Counties,2020-08-30,6,882,5,486,1,396,0,0,5,788,1,46,5,834,,0,0,28671193
102,All CA Counties,2020-08-31,101,983,69,555,32,428,0,0,77,842,23,69,77,911,,0,0,28671193
103,All CA Counties,2020-09-01,124,1107,87,642,37,465,0,0,91,901,32,101,91,1002,,0,0,28671193
104,All CA Counties,2020-09-02,77,1184,60,702,17,482,0,0,55,934,22,123,55,1057,,0,0,28671193
105,All CA Counties,2020-09-03,74,1258,50,752,24,506,0,0,64,988,10,133,64,1121,,0,0,28671193
106,All CA Counties,2020-09-04,81,1339,61,813,20,526,0,0,55,1017,26,159,55,1176,,0,0,28671193
107,All CA Counties,2020-09-05,15,1354,2,815,13,539,0,0,15,1032,0,159,15,1191,,0,0,28671193
108,All CA Counties,2020-09-06,2,1356,2,817,0,539,0,0,2,1034,0,159,2,1193,,0,0,28671193
109,All CA Counties,2020-09-07,7,1363,3,820,4,543,0,0,5,1037,2,161,5,1198,,0,0,28671193
110,All CA Counties,2020-09-08,112,1475,64,884,48,591,0,0,58,1042,53,214,58,1256,,0,0,28671193
111,All CA Counties,2020-09-09,103,1578,78,962,25,616,0,0,53,1045,50,264,53,1309,,0,0,28671193
112,All CA Counties,2020-09-10,84,1662,56,1018,28,644,0,0,46,1053,38,302,46,1355,,0,0,28671193
113,All CA Counties,2020-09-11,82,1744,60,1078,22,666,0,0,50,1071,32,334,50,1405,,0,0,28671193
114,All CA Counties,2020-09-12,29,1773,17,1095,12,678,0,0,18,1078,11,345,18,1423,,0,0,28671193
115,All CA Counties,2020-09-13,11,1784,11,1106,0,678,0,0,4,1075,7,352,4,1427,,0,0,28671193
116,All CA Counties,2020-09-14,87,1871,57,1163,30,708,0,0,21,1031,65,417,21,1448,,0,0,28671193
117,All CA Counties,2020-09-15,83,1954,58,1221,25,733,0,0,28,1004,55,472,28,1476,,0,0,28671193
118,All CA Counties,2020-09-16,73,2027,54,1275,19,752,0,0,31,993,42,514,31,1507,,0,0,28671193
119,All CA Counties,2020-09-17,71,2098,41,1316,30,782,0,0,30,983,40,554,30,1537,,0,0,28671193
120,All CA Counties,2020-09-18,78,2176,56,1372,22,804,0,0,30,966,47,601,30,1567,,0,0,28671193
121,All CA Counties,2020-09-19,20,2196,17,1389,3,807,0,0,11,968,9,610,11,1578,,0,0,28671193
122,All CA Counties,2020-09-20,9,2205,8,1397,1,808,0,0,6,971,3,613,6,1584,,0,0,28671193
123,All CA Counties,2020-09-21,104,2309,80,1477,24,832,0,0,29,925,75,688,29,1613,,0,0,28671193
124,All CA Counties,2020-09-22,93,2402,67,1544,26,858,0,0,32,896,61,749,32,1645,,0,0,28671193
125,All CA Counties,2020-09-23,105,2507,82,1626,21,879,2,2,33,859,72,821,35,1680,,0,0,28671193
126,All CA Counties,2020-09-24,67,2574,58,1684,9,888,0,2,17,828,48,869,17,1697,,0,0,28671193
127,All CA Counties,2020-09-25,77,2651,52,1736,25,913,0,2,20,791,57,926,20,1717,,0,0,28671193
128,All CA Counties,2020-09-26,12,2663,7,1743,5,918,0,2,4,787,8,934,4,1721,,0,0,28671193
129,All CA Counties,2020-09-27,2,2665,2,1745,0,918,0,2,2,789,0,934,2,1723,,0,0,28671193
130,All CA Counties,2020-09-28,61,2726,31,1776,30,948,0,2,6,740,55,989,6,1729,,0,0,28671193
131,All CA Counties,2020-09-29,55,2781,39,1815,14,962,2,4,6,699,49,1038,8,1737,,0,0,28671193
132,All CA Counties,2020-09-30,59,2840,39,1854,18,980,2,6,9,660,50,1088,11,1748,,0,0,28671193
133,All CA Counties,2020-10-01,63,2903,38,1892,22,1002,3,9,30,660,33,1121,33,1781,,0,0,28671193
134,All CA Counties,2020-10-02,31,2934,24,1916,7,1009,0,9,7,643,24,1145,7,1788,,0,0,28671193
135,All CA Counties,2020-10-03,17,2951,7,1923,9,1018,1,10,2,631,15,1160,3,1791,,0,0,28671193
136,All CA Counties,2020-10-04,2,2953,2,1925,0,1018,0,10,2,633,0,1160,2,1793,,0,0,28671193
137,All CA Counties,2020-10-05,29,2982,21,1946,8,1026,0,10,11,628,16,1176,11,1804,,0,0,28671193
138,All CA Counties,2020-10-06,37,3019,29,1975,6,1032,2,12,7,607,30,1206,9,1813,,0,0,28671193
139,All CA Counties,2020-10-07,47,3066,22,1997,22,1054,3,15,8,579,39,1245,11,1824,,0,0,28671193
140,All CA Counties,2020-10-08,43,3109,30,2027,11,1065,2,17,18,574,25,1270,20,1844,,0,0,28671193
141,All CA Counties,2020-10-09,43,3152,23,2050,20,1085,0,17,8,547,35,1305,8,1852,,0,0,28671193
142,All CA Counties,2020-10-10,22,3174,11,2061,5,1090,6,23,7,545,15,1320,13,1865,,0,0,28671193
143,All CA Counties,2020-10-11,6,3180,2,2063,3,1093,1,24,4,548,2,1322,5,1870,,0,0,28671193
144,All CA Counties,2020-10-12,45,3225,32,2095,12,1105,1,25,10,524,35,1357,11,1881,,0,0,28671193
145,All CA Counties,2020-10-13,36,3261,24,2119,12,1117,0,25,8,504,28,1385,8,1889,,0,0,28671193
146,All CA Counties,2020-10-14,39,3300,25,2144,13,1130,1,26,12,490,27,1412,13,1902,,0,0,28671193
147,All CA Counties,2020-10-15,35,3335,25,2169,9,1139,1,27,16,489,18,1430,17,1919,,0,0,28671193
148,All CA Counties,2020-10-16,35,3370,24,2193,10,1149,1,28,17,489,18,1448,18,1937,,0,0,28671193
149,All CA Counties,2020-10-17,10,3380,7,2200,3,1152,0,28,5,489,5,1453,5,1942,,0,0,28671193
150,All CA Counties,2020-10-18,7,3387,7,2207,0,1152,0,28,7,496,0,1453,7,1949,,0,0,28671193
151,All CA Counties,2020-10-19,36,3423,27,2234,7,1159,2,30,27,516,9,1462,29,1978,,0,0,28671193
152,All CA Counties,2020-10-20,23,3446,8,2242,15,1174,0,30,19,531,4,1466,19,1997,,0,0,28671193
153,All CA Counties,2020-10-21,42,3488,31,2273,9,1183,2,32,30,553,9,1475,31,2028,,0,0,28671193
154,All CA Counties,2020-10-22,22,3510,17,2290,5,1188,0,32,19,569,3,1478,19,2047,,0,0,28671193
155,All CA Counties,2020-10-23,29,3539,14,2304,15,1203,0,32,22,584,7,1485,22,2069,,0,0,28671193
156,All CA Counties,2020-10-24,15,3554,13,2317,2,1205,0,32,15,599,0,1485,15,2084,,0,0,28671193
157,All CA Counties,2020-10-25,7,3561,3,2320,4,1209,0,32,7,606,0,1485,7,2091,,0,0,28671193
158,All CA Counties,2020-10-26,25,3586,16,2336,7,1216,2,34,19,621,6,1491,21,2112,,0,0,28671193
159,All CA Counties,2020-10-27,24,3610,16,2352,6,1222,2,36,15,630,8,1499,17,2129,,0,0,28671193
160,All CA Counties,2020-10-28,16,3626,5,2357,11,1233,0,36,14,642,2,1501,14,2143,,0,0,28671193
161,All CA Counties,2020-10-29,16,3642,9,2366,6,1239,1,37,11,650,4,1505,12,2155,,0,0,28671193
162,All CA Counties,2020-10-30,20,3662,10,2376,9,1248,1,38,9,649,11,1516,10,2165,,0,0,28671193
163,All CA Counties,2020-10-31,11,3673,4,2380,2,1250,5,43,5,653,6,1522,10,2175,,0,0,28671193
164,All CA Counties,2020-11-01,47,3720,26,2406,13,1263,8,51,34,682,13,1535,42,2217,,0,0,28671193
165,All CA Counties,2020-11-02,33,3753,14,2420,13,1276,6,57,21,697,12,1547,27,2244,,0,0,28671193
166,All CA Counties,2020-11-03,17,3770,6,2426,7,1283,4,61,10,704,7,1554,14,2258,,0,0,28671193
167,All CA Counties,2020-11-04,31,3801,12,2438,8,1291,11,72,12,708,19,1573,23,2281,,0,0,28671193
168,All CA Counties,2020-11-05,74,3875,46,2484,22,1313,6,78,61,762,13,1586,67,2348,,0,0,28671193
169,All CA Counties,2020-11-06,8,3883,3,2487,2,1315,3,81,3,763,5,1591,6,2354,,0,0,28671193
170,All CA Counties,2020-11-07,4,3887,3,2490,0,1315,1,82,1,762,3,1594,2,2356,,0,0,28671193
171,All CA Counties,2020-11-08,6,3893,3,2493,2,1317,1,83,5,767,1,1595,6,2362,,0,0,28671193
172,All CA Counties,2020-11-09,19,3912,9,2502,7,1324,3,86,5,761,14,1609,8,2370,,0,0,28671193
173,All CA Counties,2020-11-10,32,3944,13,2515,9,1333,10,96,14,767,18,1627,24,2394,,0,0,28671193
174,All CA Counties,2020-11-11,51,3995,35,2550,9,1342,7,103,20,763,31,1658,27,2421,,0,0,28671193
175,All CA Counties,2020-11-12,28,4023,10,2560,7,1349,11,114,4,754,23,1681,14,2435,,0,0,28671193
176,All CA Counties,2020-11-13,45,4068,22,2582,4,1353,19,133,10,748,35,1716,29,2464,,0,0,28671193
177,All CA Counties,2020-11-14,21,4089,8,2590,2,1355,11,144,6,750,15,1731,17,2481,,0,0,28671193
178,All CA Counties,2020-11-15,23,4112,6,2596,7,1362,10,154,13,763,10,1741,23,2504,,0,0,28671193
179,All CA Counties,2020-11-16,41,4153,15,2611,10,1372,16,170,16,770,25,1766,32,2536,,0,0,28671193
180,All CA Counties,2020-11-17,39,4192,19,2630,14,1386,6,176,20,777,19,1785,26,2562,,0,0,28671193
181,All CA Counties,2020-11-18,42,4234,17,2647,13,1399,12,188,26,800,15,1800,38,2600,,0,0,28671193
182,All CA Counties,2020-11-19,33,4267,10,2657,5,1404,18,206,11,808,20,1820,28,2628,,0,0,28671193
183,All CA Counties,2020-11-20,55,4322,14,2671,16,1420,25,231,22,822,33,1853,47,2675,,0,0,28671193
184,All CA Counties,2020-11-21,10,4332,5,2676,1,1421,4,235,5,826,5,1858,9,2684,,0,0,28671193
185,All CA Counties,2020-11-22,28,4360,15,2691,2,1423,11,246,15,839,12,1870,25,2709,,0,0,28671193
186,All CA Counties,2020-11-23,37,4397,14,2705,7,1430,16,262,16,851,20,1890,32,2741,,0,0,28671193
187,All CA Counties,2020-11-24,38,4435,13,2718,9,1439,16,278,19,867,19,1909,35,2776,,0,0,28671193
188,All CA Counties,2020-11-25,19,4454,6,2724,5,1444,8,286,8,872,11,1920,16,2792,,0,0,28671193
189,All CA Counties,2020-11-26,9,4463,5,2729,3,1447,1,287,8,880,1,1921,9,2801,,0,0,28671193
190,All CA Counties,2020-11-27,18,4481,6,2735,4,1451,8,295,9,888,8,1929,16,2817,,0,0,28671193
191,All CA Counties,2020-11-28,19,4500,10,2745,7,1458,2,297,14,899,5,1934,16,2833,,0,0,28671193
192,All CA Counties,2020-11-29,7,4507,1,2746,6,1464,0,297,6,904,1,1935,6,2839,,0,0,28671193
193,All CA Counties,2020-11-30,41,4548,18,2764,14,1478,9,306,29,930,11,1946,37,2876,,0,0,28671193
194,All CA Counties,2020-12-01,474,5022,312,3076,123,1601,39,345,419,1333,55,2001,458,3334,,0,0,28671193
195,All CA Counties,2020-12-02,127,5149,91,3167,17,1618,19,364,102,1429,24,2025,120,3454,,0,0,28671193
196,All CA Counties,2020-12-03,136,5285,52,3219,62,1680,22,386,112,1539,24,2049,134,3588,,0,0,28671193
197,All CA Counties,2020-12-04,72,5357,22,3241,21,1701,29,415,40,1576,32,2081,69,3657,,0,0,28671193
198,All CA Counties,2020-12-05,49,5406,19,3260,10,1711,20,435,28,1603,20,2101,47,3704,,0,0,28671193
199,All CA Counties,2020-12-06,41,5447,26,3286,12,1723,3,438,38,1641,3,2104,41,3745,,0,0,28671193
200,All CA Counties,2020-12-07,112,5559,64,3350,27,1750,21,459,88,1725,24,2128,108,3853,,0,0,28671193
201,All CA Counties,2020-12-08,121,5680,67,3417,20,1770,34,493,84,1807,36,2164,118,3971,,0,0,28671193
202,All CA Counties,2020-12-09,59,5739,36,3453,8,1778,15,508,41,1845,18,2182,56,4027,,0,0,28671193
203,All CA Counties,2020-12-10,83,5822,31,3484,16,1794,36,544,45,1888,38,2220,81,4108,,0,0,28671193
204,All CA Counties,2020-12-11,104,5926,42,3526,18,1812,44,588,58,1944,46,2266,102,4210,,0,0,28671193
205,All CA Counties,2020-12-12,83,6009,55,3581,18,1830,10,598,73,2017,10,2276,83,4293,,0,0,28671193
206,All CA Counties,2020-12-13,73,6082,43,3624,24,1854,6,604,67,2084,6,2282,73,4366,,0,0,28671193
207,All CA Counties,2020-12-14,121,6203,63,3687,30,1884,24,628,90,2171,27,2309,114,4480,,0,0,28671193
208,All CA Counties,2020-12-15,1428,7631,1333,5020,55,1939,35,663,1375,3538,43,2352,1410,5890,,0,0,28671193
209,All CA Counties,2020-12-16,9593,17224,9527,14547,30,1969,29,692,9504,13032,38,2390,9532,15422,,0,0,28671193
210,All CA Counties,2020-12-17,29107,46331,29016,43563,35,2004,42,734,28950,41973,51,2441,28992,44414,,0,0,28671193
211,All CA Counties,2020-12-18,48621,94952,48528,92091,79,2083,3,737,48454,90390,40,2481,48457,92871,,0,0,28671193
212,All CA Counties,2020-12-19,26780,121732,26742,118833,33,2116,0,737,26724,117084,30,2511,26724,119595,,0,0,28671193
213,All CA Counties,2020-12-20,20033,141765,19905,138738,112,2228,5,742,19986,137052,23,2534,19991,139586,,0,0,28671193
214,All CA Counties,2020-12-21,52571,194336,52406,191144,148,2376,0,742,52310,189266,96,2630,52310,191896,,0,0,28671193
215,All CA Counties,2020-12-22,53029,247365,50489,241633,2526,4902,3,745,52765,241975,59,2689,52768,244664,,0,0,28671193
216,All CA Counties,2020-12-23,53653,301018,43879,285512,9749,14651,6,751,53371,295299,53,2742,53377,298041,,0,0,28671193
217,All CA Counties,2020-12-24,25177,326195,16935,302447,8233,22884,3,754,25108,320392,17,2759,25110,323151,,0,0,28671193
218,All CA Counties,2020-12-25,2458,328653,2104,304551,352,23236,1,755,2452,322843,2,2761,2453,325604,,0,0,28671193
219,All CA Counties,2020-12-26,15386,344039,9806,314357,5577,28813,1,756,15362,338193,13,2774,15363,340967,,0,0,28671193
220,All CA Counties,2020-12-27,9871,353910,5796,320153,4071,32884,1,757,9840,348024,10,2784,9841,350808,,0,0,28671193
221,All CA Counties,2020-12-28,48765,402675,31006,351159,17732,50616,7,764,48514,396473,72,2856,48521,399329,,0,0,28671193
222,All CA Counties,2020-12-29,55150,457825,30888,382047,24236,74852,1,765,54920,451347,47,2903,54921,454250,,0,0,28671193
223,All CA Counties,2020-12-30,66874,524699,37672,419719,29177,104029,2,767,66591,517867,73,2976,66593,520843,,0,0,28671193
224,All CA Counties,2020-12-31,31369,556068,11600,431319,19750,123779,3,770,31216,549027,58,3034,31218,552061,,0,0,28671193
225,All CA Counties,2021-01-01,7121,563189,3301,434620,3508,127287,203,973,6701,555664,267,3301,6904,558965,,0,0,28671193
226,All CA Counties,2021-01-02,19406,582595,10802,445422,8578,135865,10,983,19221,574763,132,3433,19231,578196,,0,0,28671193
227,All CA Counties,2021-01-03,6875,589470,3890,449312,2950,138815,14,997,6751,581471,57,3490,6765,584961,,0,0,28671193
228,All CA Counties,2021-01-04,48950,638420,26001,475313,22885,161700,18,1015,45769,624327,2931,6421,45787,630748,,0,0,28671193
229,All CA Counties,2021-01-05,59959,698379,31841,507154,28056,189756,13,1028,53490,671736,6094,12515,53503,684251,,0,0,28671193
230,All CA Counties,2021-01-06,77675,776054,43061,550215,34557,224313,10,1038,59958,714517,17187,29702,59968,744219,,0,0,28671193
231,All CA Counties,2021-01-07,98419,874473,56617,606832,41736,266049,11,1049,63744,744202,34069,63771,63754,807973,,0,0,28671193
232,All CA Counties,2021-01-08,113727,988200,68584,675416,45073,311122,13,1062,67961,766881,45295,109066,67974,875947,,0,0,28671193
233,All CA Counties,2021-01-09,46669,1034869,26873,702289,19767,330889,12,1074,28920,778176,17637,126703,28932,904879,,0,0,28671193
234,All CA Counties,2021-01-10,25367,1060236,15548,717837,9771,340660,14,1088,13556,780013,11732,138435,13569,918448,,0,0,28671193
235,All CA Counties,2021-01-11,109651,1169887,73052,790889,36539,377199,12,1100,62920,796725,46219,184654,62931,981379,,0,0,28671193
236,All CA Counties,2021-01-12,119563,1289450,71063,861952,48449,425648,12,1112,75246,828292,43691,228345,75258,1056637,,0,0,28671193
237,All CA Counties,2021-01-13,124691,1414141,65149,927101,59492,485140,9,1121,88377,880826,35850,264195,88384,1145021,,0,0,28671193
238,All CA Counties,2021-01-14,129529,1543670,52324,979425,77137,562277,9,1130,108480,968849,20465,284660,108488,1253509,,0,0,28671193
239,All CA Counties,2021-01-15,147681,1691351,54136,1033561,93479,655756,14,1144,131228,1084184,15907,300567,131242,1384751,,0,0,28671193
240,All CA Counties,2021-01-16,83928,1775279,28201,1061762,55695,711451,8,1152,75739,1151934,7997,308564,75747,1460498,,0,0,28671193
241,All CA Counties,2021-01-17,49048,1824327,17233,1078995,31799,743250,3,1155,44998,1193007,3927,312491,45000,1505498,,0,0,28671193
242,All CA Counties,2021-01-18,90368,1914695,47350,1126345,42967,786217,11,1166,69850,1242753,20114,332605,69860,1575358,,0,0,28671193
243,All CA Counties,2021-01-19,148325,2063020,77033,1203378,71214,857431,12,1178,113975,1323045,33692,366297,113984,1689342,,0,0,28671193
244,All CA Counties,2021-01-20,168691,2231711,86801,1290179,81807,939238,13,1191,132001,1419133,35923,402220,132011,1821353,,0,0,28671193
245,All CA Counties,2021-01-21,182754,2414465,81844,1372023,100826,1040064,15,1206,160875,1559208,20815,423035,160890,1982243,,0,0,28671193
246,All CA Counties,2021-01-22,176042,2590507,71348,1443371,104634,1144698,7,1213,159859,1703648,15425,438460,159865,2142108,,0,0,28671193
247,All CA Counties,2021-01-23,115363,2705870,50495,1493866,64814,1209512,8,1221,102141,1792898,12897,451357,102147,2244255,,0,0,28671193
248,All CA Counties,2021-01-24,62363,2768233,29929,1523795,32404,1241916,3,1224,57295,1845342,4854,456211,57298,2301553,,0,0,28671193
249,All CA Counties,2021-01-25,151728,2919961,68099,1591894,83543,1325459,11,1235,113675,1921719,37309,493520,113686,2415239,,0,0,28671193
250,All CA Counties,2021-01-26,176902,3096863,87038,1678932,89792,1415251,12,1247,135816,2017191,40354,533874,135826,2551065,,0,0,28671193
251,All CA Counties,2021-01-27,191167,3288030,92371,1771303,98710,1513961,11,1258,148342,2123650,41891,575765,148350,2699415,,0,0,28671193
252,All CA Counties,2021-01-28,197069,3485099,91141,1862444,105839,1619800,11,1269,159469,2246541,36588,612353,159479,2858894,,0,0,28671193
253,All CA Counties,2021-01-29,192182,3677281,92317,1954761,99746,1719546,15,1284,154471,2364545,36479,648832,154483,3013377,,0,0,28671193
254,All CA Counties,2021-01-30,129462,3806743,57973,2012734,71437,1790983,8,1292,112944,2461405,16092,664924,112952,3126329,,0,0,28671193
255,All CA Counties,2021-01-31,72790,3879533,40966,2053700,31777,1822760,12,1304,67376,2523655,5137,670061,67387,3193716,,0,0,28671193
256,All CA Counties,2021-02-01,169588,4049121,78976,2132676,90266,1913026,130,1434,125189,2605443,43527,713588,125315,3319031,,0,0,28671193
257,All CA Counties,2021-02-02,193622,4242743,81361,2214037,112123,2025149,23,1457,145438,2703471,47430,761018,145458,3464489,,0,0,28671193
258,All CA Counties,2021-02-03,219406,4462149,98607,2312644,120648,2145797,14,1471,160972,2807099,57355,818373,160983,3625472,,0,0,28671193
259,All CA Counties,2021-02-04,236116,4698265,102651,2415295,133328,2279125,15,1486,171104,2914357,63860,882233,171118,3796590,,0,0,28671193
260,All CA Counties,2021-02-05,256559,4954824,108996,2524291,147414,2426539,17,1503,172001,3003240,83133,965366,172016,3968606,,0,0,28671193
261,All CA Counties,2021-02-06,161603,5116427,77239,2601530,84293,2510832,27,1530,124717,3091652,36329,1001695,124741,4093347,,0,0,28671193
262,All CA Counties,2021-02-07,69659,5186086,45416,2646946,24207,2535039,12,1542,52282,3126786,17160,1018855,52294,4145641,,0,0,28671193
263,All CA Counties,2021-02-08,188796,5374882,93027,2739973,95639,2630678,24,1566,123183,3185233,64756,1083611,123203,4268844,,0,0,28671193
264,All CA Counties,2021-02-09,218717,5593599,105444,2845417,113118,2743796,32,1598,128670,3224705,89224,1172835,128696,4397540,,0,0,28671193
265,All CA Counties,2021-02-10,257890,5851489,123161,2968578,134509,2878305,22,1620,139267,3247054,116939,1289774,139288,4536828,,0,0,28671193
266,All CA Counties,2021-02-11,274380,6125869,135088,3103666,139137,3017442,34,1654,146615,3267507,126193,1415967,146646,4683474,,0,0,28671193
267,All CA Counties,2021-02-12,281119,6406988,122364,3226030,158602,3176044,31,1685,149251,3286386,130397,1546364,149276,4832750,,0,0,28671193
268,All CA Counties,2021-02-13,171912,6578900,78899,3304929,92932,3268976,11,1696,93702,3302520,77577,1623941,93711,4926461,,0,0,28671193
269,All CA Counties,2021-02-14,98088,6676988,48806,3353735,49247,3318223,12,1708,52131,3309014,45647,1669588,52141,4978602,,0,0,28671193
270,All CA Counties,2021-02-15,146936,6823924,64443,3418178,82379,3400602,38,1746,79719,3322180,66588,1736176,79754,5058356,,0,0,28671193
271,All CA Counties,2021-02-16,258411,7082335,122443,3540621,135840,3536442,23,1769,134730,3334114,122815,1858991,134749,5193105,,0,0,28671193
272,All CA Counties,2021-02-17,269736,7352071,134613,3675234,134974,3671416,39,1808,130270,3326031,138383,1997374,130300,5323405,,0,0,28671193
273,All CA Counties,2021-02-18,284363,7636434,148281,3823515,135925,3807341,22,1830,133540,3310001,149589,2146963,133559,5456964,,0,0,28671193
274,All CA Counties,2021-02-19,264800,7901234,153644,3977159,111031,3918372,19,1849,133326,3312797,130548,2277511,133344,5590308,,0,0,28671193
275,All CA Counties,2021-02-20,162592,8063826,103685,4080844,58255,3976627,19,1868,86292,3323893,75214,2352725,86310,5676618,,0,0,28671193
276,All CA Counties,2021-02-21,91071,8154897,73486,4154330,17504,3994131,17,1885,44619,3322643,45884,2398609,44634,5721252,,0,0,28671193
277,All CA Counties,2021-02-22,178058,8332955,118991,4273321,58925,4053056,23,1908,86596,3318526,90735,2489344,86618,5807870,,0,0,28671193
278,All CA Counties,2021-02-23,244370,8577325,128538,4401859,115696,4168752,23,1931,109854,3294797,133597,2622941,109868,5917738,,0,0,28671193
279,All CA Counties,2021-02-24,304283,8881608,153953,4555812,150180,4318932,20,1951,140274,3272223,162866,2785807,140292,6058030,,0,0,28671193
280,All CA Counties,2021-02-25,344917,9226525,170330,4726142,174398,4493330,23,1974,176817,3282367,166687,2952494,176831,6234861,,0,0,28671193
281,All CA Counties,2021-02-26,379593,9606118,177039,4903181,202352,4695682,28,2002,206737,3317917,171211,3123705,206761,6441622,,0,0,28671193
282,All CA Counties,2021-02-27,271788,9877906,131925,5035106,139749,4835431,55,2057,149827,3347081,120715,3244420,149879,6591501,,0,0,28671193
283,All CA Counties,2021-02-28,145727,10023633,87346,5122452,58301,4893732,25,2082,82257,3366566,62794,3307214,82279,6673780,,0,0,28671193
284,All CA Counties,2021-03-01,265468,10289101,140939,5263391,123554,5017286,490,2572,150359,3404091,113314,3420528,150839,6824619,,0,0,28671193
285,All CA Counties,2021-03-02,318119,10607220,159440,5422831,158186,5175472,97,2669,185693,3458795,131067,3551595,185771,7010390,,0,0,28671193
286,All CA Counties,2021-03-03,358475,10965695,177936,5600767,179856,5355328,157,2826,202842,3507852,153930,3705525,202987,7213377,,0,0,28671193
287,All CA Counties,2021-03-04,378681,11344376,191338,5792105,186586,5541914,169,2995,216892,3564985,159891,3865416,217024,7430401,,0,0,28671193
288,All CA Counties,2021-03-05,366765,11711141,178274,5970379,186332,5728246,1477,4472,221839,3645410,142880,4008296,223305,7653706,,0,0,28671193
289,All CA Counties,2021-03-06,272901,11984042,138956,6109335,125199,5853445,8250,12722,165939,3713828,105684,4113980,174102,7827808,,0,0,28671193
290,All CA Counties,2021-03-07,141158,12125200,83081,6192416,50628,5904073,7334,20056,85835,3752107,54859,4168839,93138,7920946,,0,0,28671193
291,All CA Counties,2021-03-08,235558,12360758,114079,6306495,109155,6013228,11700,31756,151183,3831818,83127,4251966,162838,8083784,,0,0,28671193
292,All CA Counties,2021-03-09,307985,12668743,146427,6452922,143809,6157037,17202,48958,169968,3882321,136562,4388528,187065,8270849,,0,0,28671193
293,All CA Counties,2021-03-10,340666,13009409,168226,6621148,146134,6303171,25761,74719,180517,3929868,158625,4547153,206172,8477021,,0,0,28671193
294,All CA Counties,2021-03-11,392590,13401999,189628,6810776,168092,6471263,34545,109264,197511,3968335,193464,4740617,231931,8708952,,0,0,28671193
295,All CA Counties,2021-03-12,411286,13813285,183402,6994178,180086,6651349,47313,156577,197118,4000161,212414,4953031,244240,8953192,,0,0,28671193
296,All CA Counties,2021-03-13,295238,14108523,128466,7122644,134365,6785714,32096,188673,155253,4048453,138945,5091976,187237,9140429,,0,0,28671193
297,All CA Counties,2021-03-14,160773,14269296,85232,7207876,59922,6845636,15503,204176,79215,4062143,80968,5172944,94658,9235087,,0,0,28671193
298,All CA Counties,2021-03-15,300325,14569621,143458,7351334,135159,6980795,21346,225522,160400,4105302,138505,5311449,181664,9416751,,0,0,28671193
299,All CA Counties,2021-03-16,382686,14952307,180508,7531842,183880,7164675,17978,243500,217633,4177312,163494,5474943,235504,9652255,,0,0,28671193
300,All CA Counties,2021-03-17,400883,15353190,198917,7730759,182072,7346747,19585,263085,243393,4284314,155829,5630772,262831,9915086,,0,0,28671193
301,All CA Counties,2021-03-18,416683,15769873,213560,7944319,183676,7530423,19134,282219,241690,4371962,173073,5803845,260721,10175807,,0,0,28671193
302,All CA Counties,2021-03-19,425708,16195581,224405,8168724,178430,7708853,22588,304807,241033,4452457,182971,5986816,263466,10439273,,0,0,28671193
303,All CA Counties,2021-03-20,305531,16501112,160717,8329441,128023,7836876,16567,321374,189799,4544274,114473,6101289,206290,10645563,,0,0,28671193
304,All CA Counties,2021-03-21,149313,16650425,102748,8432189,38670,7875546,7786,329160,87786,4579047,60735,6162024,95508,10741071,,0,0,28671193
305,All CA Counties,2021-03-22,282253,16932678,164266,8596455,106195,7981741,11539,340699,179945,4669486,100976,6263000,191415,10932486,,0,0,28671193
306,All CA Counties,2021-03-23,369193,17301871,203378,8799833,154146,8135887,11438,352137,220426,4753945,147342,6410342,231801,11164287,,0,0,28671193
307,All CA Counties,2021-03-24,399800,17701671,228029,9027862,158481,8294368,13067,365204,225755,4820295,172384,6582726,238734,11403021,,0,0,28671193
308,All CA Counties,2021-03-25,432431,18134102,237859,9265721,178688,8473056,15640,380844,237376,4879928,193279,6776005,252912,11655933,,0,0,28671193
309,All CA Counties,2021-03-26,450860,18584962,240283,9506004,193481,8666537,16842,397686,236576,4920584,212656,6988661,253312,11909245,,0,0,28671193
310,All CA Counties,2021-03-27,323414,18908376,171608,9677612,139339,8805876,12281,409967,158761,4928062,163481,7152142,170959,12080204,,0,0,28671193
311,All CA Counties,2021-03-28,174577,19082953,112258,9789870,58436,8864312,3801,413768,88564,4935000,85405,7237547,92343,12172547,,0,0,28671193
312,All CA Counties,2021-03-29,322920,19405873,172904,9962774,140250,9004562,9580,423348,173282,4969370,148435,7385982,182805,12355352,,0,0,28671193
313,All CA Counties,2021-03-30,412943,19818816,208731,10171505,184963,9189525,18958,442306,224505,5025736,186961,7572943,243327,12598679,,0,0,28671193
314,All CA Counties,2021-03-31,439898,20258714,238270,10409775,178613,9368138,22716,465022,238210,5086581,199916,7772859,260761,12859440,,0,0,28671193
315,All CA Counties,2021-04-01,510374,20769088,260164,10669939,207302,9575440,42341,507363,272910,5166849,234646,8007505,314914,13174354,,0,0,28671193
316,All CA Counties,2021-04-02,489360,21258448,237911,10907850,206296,9781736,44796,552159,257509,5239098,229863,8237368,302112,13476466,,0,0,28671193
317,All CA Counties,2021-04-03,337830,21596278,171844,11079694,122955,9904691,42746,594905,164901,5274804,171743,8409111,207449,13683915,,0,0,28671193
318,All CA Counties,2021-04-04,135270,21731548,70651,11150345,45114,9949805,19401,614306,57044,5273562,77618,8486729,76376,13760291,,0,0,28671193
319,All CA Counties,2021-04-05,368162,22099710,188623,11338968,137358,10087163,41865,656171,174590,5297634,192161,8678890,216233,13976524,,0,0,28671193
320,All CA Counties,2021-04-06,471469,22571179,238602,11577570,165048,10252211,67488,723659,222975,5340991,246776,8925666,290133,14266657,,0,0,28671193
321,All CA Counties,2021-04-07,487430,23058609,252493,11830063,162212,10414423,72368,796027,230895,5389055,254814,9180480,302878,14569535,,0,0,28671193
322,All CA Counties,2021-04-08,515122,23573731,259416,12089479,168035,10582458,87332,883359,237431,5437705,275673,9456153,324323,14893858,,0,0,28671193
323,All CA Counties,2021-04-09,510891,24084622,253413,12342892,174322,10756780,82754,966113,229733,5470449,279296,9735449,312040,15205898,,0,0,28671193
324,All CA Counties,2021-04-10,379941,24464563,172600,12515492,130370,10887150,76706,1042819,156383,5480939,222247,9957696,232737,15438635,,0,0,28671193
325,All CA Counties,2021-04-11,193569,24658132,108348,12623840,49844,10936994,35259,1078078,78467,5480127,114375,10072071,113563,15552198,,0,0,28671193
326,All CA Counties,2021-04-12,350853,25008985,179690,12803530,130958,11067952,39833,1117911,158641,5487771,190570,10262641,198214,15750412,,0,0,28671193
327,All CA Counties,2021-04-13,443184,25452169,247739,13051269,194166,11262118,987,1118898,242769,5532840,198638,10461279,243707,15994119,,0,0,28671193
328,All CA Counties,2021-04-14,463623,25915792,259460,13310729,203369,11465487,368,1119266,236940,5545593,224500,10685779,237253,16231372,,0,0,28671193
329,All CA Counties,2021-04-15,503602,26419394,292507,13603236,210282,11675769,376,1119642,275804,5596531,225196,10910975,276134,16507506,,0,0,28671193
330,All CA Counties,2021-04-16,490011,26909405,274581,13877817,214680,11890449,340,1119982,255721,5620564,232004,11142979,256037,16763543,,0,0,28671193
331,All CA Counties,2021-04-17,353194,27262599,197479,14075296,155313,12045762,89,1120071,197359,5663723,154273,11297252,197432,16960975,,0,0,28671193
332,All CA Counties,2021-04-18,167061,27429660,108036,14183332,58872,12104634,35,1120106,83951,5665330,82375,11379627,83982,17044957,,0,0,28671193
333,All CA Counties,2021-04-19,328203,27757863,188181,14371513,139480,12244114,134,1120240,151186,5641278,175337,11554964,151285,17196242,,0,0,28671193
334,All CA Counties,2021-04-20,424770,28182633,229388,14600901,194786,12438900,135,1120375,205243,5629331,217284,11772248,205337,17401579,,0,0,28671193
335,All CA Counties,2021-04-21,450867,28633500,260093,14860994,189879,12628779,393,1120768,212792,5607259,235168,12007416,213096,17614675,,0,0,28671193
336,All CA Counties,2021-04-22,468457,29101957,268763,15129757,199056,12827835,118,1120886,205375,5552245,260473,12267889,205459,17820134,,0,0,28671193
337,All CA Counties,2021-04-23,461028,29562985,264086,15393843,196387,13024222,126,1121012,205495,5504715,253106,12520995,205576,18025710,,0,0,28671193
338,All CA Counties,2021-04-24,335313,29898298,209657,15603500,125143,13149365,224,1121236,167224,5505836,166303,12687298,167424,18193134,,0,0,28671193
339,All CA Counties,2021-04-25,154827,30053125,101349,15704849,53255,13202620,104,1121340,81494,5514893,72522,12759820,81579,18274713,,0,0,28671193
340,All CA Counties,2021-04-26,313772,30366897,182282,15887131,129379,13331999,1664,1123004,134358,5473288,177557,12937377,135952,18410665,,0,0,28671193
341,All CA Counties,2021-04-27,382824,30749721,211762,16098893,163666,13495665,6952,1129956,151167,5401664,229659,13167036,158035,18568700,,0,0,28671193
342,All CA Counties,2021-04-28,370018,31119739,212829,16311722,148515,13644180,8296,1138252,149243,5340384,218707,13385743,157427,18726127,,0,0,28671193
343,All CA Counties,2021-04-29,381523,31501262,220120,16531842,152626,13796806,8439,1146691,136928,5243157,242489,13628232,145262,18871389,,0,0,28671193
344,All CA Counties,2021-04-30,395914,31897176,226258,16758100,159749,13956555,9540,1156231,147373,5153652,246269,13874501,156764,19028153,,0,0,28671193
345,All CA Counties,2021-05-01,261416,32158592,164717,16922817,89788,14046343,6681,1162912,94194,5089051,165330,14039831,100729,19128882,,0,0,28671193
346,All CA Counties,2021-05-02,120961,32279553,84706,17007523,32074,14078417,4109,1167021,41515,5055847,78775,14118606,45571,19174453,,0,0,28671193
347,All CA Counties,2021-05-03,257050,32536603,155883,17163406,91802,14170219,9116,1176137,75777,4960771,179855,14298461,84779,19259232,,0,0,28671193
348,All CA Counties,2021-05-04,335487,32872090,203230,17366636,121818,14292037,10187,1186324,96559,4830169,237230,14535691,106628,19365860,,0,0,28671193
349,All CA Counties,2021-05-05,347563,33219653,216741,17583377,120083,14412120,10437,1196761,95816,4686478,249813,14785504,106122,19471982,,0,0,28671193
350,All CA Counties,2021-05-06,365276,33584929,239379,17822756,114774,14526894,10864,1207625,90333,4514796,272762,15058266,101080,19573062,,0,0,28671193
351,All CA Counties,2021-05-07,362297,33947226,227020,18049776,124882,14651776,10136,1217761,96175,4356932,264050,15322316,106186,19679248,,0,0,28671193
352,All CA Counties,2021-05-08,240219,34187445,152942,18202718,79887,14731663,7218,1224979,64607,4254381,174298,15496614,71747,19750995,,0,0,28671193
353,All CA Counties,2021-05-09,98499,34285944,74448,18277166,20910,14752573,3075,1228054,24476,4208378,73516,15570130,27513,19778508,,0,0,28671193
354,All CA Counties,2021-05-10,213497,34499441,122647,18399813,82463,14835036,8185,1236239,51113,4106482,161088,15731218,59192,19837700,,0,0,28671193
355,All CA Counties,2021-05-11,283253,34782694,162133,18561946,111884,14946920,8976,1245215,72464,3978617,209189,15940407,81324,19919024,,0,0,28671193
356,All CA Counties,2021-05-12,280029,35062723,162723,18724669,107630,15054550,9391,1254606,73364,3856176,205073,16145480,82632,20001656,,0,0,28671193
357,All CA Counties,2021-05-13,326719,35389442,210298,18934967,108475,15163025,7651,1262257,120933,3780543,204111,16349591,128478,20130134,,0,0,28671193
358,All CA Counties,2021-05-14,353095,35742537,225410,19160377,117920,15280945,9477,1271734,135669,3709978,215567,16565158,145002,20275136,,0,0,28671193
359,All CA Counties,2021-05-15,288497,36031034,200924,19361301,81173,15362118,6237,1277971,117679,3664420,169359,16734517,123801,20398937,,0,0,28671193
360,All CA Counties,2021-05-16,145504,36176538,111498,19472799,30884,15393002,3050,1281021,58320,3639303,86443,16820960,61326,20460263,,0,0,28671193
361,All CA Counties,2021-05-17,247835,36424373,162695,19635494,77228,15470230,7706,1288727,96633,3593698,149845,16970805,104240,20564503,,0,0,28671193
362,All CA Counties,2021-05-18,290573,36714946,176435,19811929,106235,15576465,7682,1296409,111813,3535902,177159,17147964,119363,20683866,,0,0,28671193
363,All CA Counties,2021-05-19,284678,36999624,177101,19989030,99419,15675884,7926,1304335,114776,3490179,168285,17316249,122562,20806428,,0,0,28671193
364,All CA Counties,2021-05-20,273383,37273007,163204,20152234,101466,15777350,8497,1312832,102622,3432205,168954,17485203,110980,20917408,,0,0,28671193
365,All CA Counties,2021-05-21,292775,37565782,179457,20331691,104769,15882119,8325,1321157,108348,3366286,182455,17667658,116536,21033944,,0,0,28671193
366,All CA Counties,2021-05-22,210745,37776527,139439,20471130,64798,15946917,6379,1327536,88155,3339449,121297,17788955,94460,21128404,,0,0,28671193
367,All CA Counties,2021-05-23,92968,37869495,64636,20535766,25507,15972424,2771,1330307,39022,3327880,53330,17842285,41761,21170165,,0,0,28671193
368,All CA Counties,2021-05-24,176029,38045524,103593,20639359,64315,16036739,7978,1338285,67119,3295218,107633,17949918,74971,21245136,,0,0,28671193
369,All CA Counties,2021-05-25,195354,38240878,114497,20753856,72565,16109304,8107,1346392,74123,3257728,119573,18069491,82083,21327219,,0,0,28671193
370,All CA Counties,2021-05-26,190502,38431380,109283,20863139,72904,16182208,8102,1354494,73101,3222946,115753,18185244,80971,21408190,,0,0,28671193
371,All CA Counties,2021-05-27,177578,38608958,101582,20964721,67353,16249561,8466,1362960,70195,3195446,106051,18291295,78551,21486741,,0,0,28671193
372,All CA Counties,2021-05-28,195054,38804012,112317,21077038,75086,16324647,7479,1370439,82126,3173553,111384,18402679,89491,21576232,,0,0,28671193
373,All CA Counties,2021-05-29,109846,38913858,67277,21144315,38516,16363163,3958,1374397,49543,3167624,59365,18462044,53436,21629668,,0,0,28671193
374,All CA Counties,2021-05-30,48670,38962528,32143,21176458,13890,16377053,2571,1376968,20852,3163662,27345,18489389,23383,21653051,,0,0,28671193
375,All CA Counties,2021-05-31,21104,38983632,12443,21188901,7522,16384575,1031,1377999,6687,3157474,13883,18503272,7695,21660746,,0,0,28671193
376,All CA Counties,2021-06-01,174565,39158197,101704,21290605,65192,16449767,7447,1385446,60737,3113635,111834,18615106,67995,21728741,,0,0,28671193
377,All CA Counties,2021-06-02,146841,39305038,86989,21377594,52592,16502359,7027,1392473,54652,3084392,90794,18705900,61551,21790292,,0,0,28671193
378,All CA Counties,2021-06-03,175919,39480957,120321,21497915,48283,16550642,7147,1399620,52422,3021640,122214,18828114,59462,21849754,,0,0,28671193
379,All CA Counties,2021-06-04,206047,39687004,145048,21642963,54370,16605012,6416,1406036,60318,2944128,144147,18972261,66635,21916389,,0,0,28671193
380,All CA Counties,2021-06-05,162271,39849275,122506,21765469,33839,16638851,5790,1411826,43702,2876147,117396,19089657,49415,21965804,,0,0,28671193
381,All CA Counties,2021-06-06,66008,39915283,55513,21820982,8097,16646948,2312,1414138,16689,2846428,48681,19138338,18962,21984766,,0,0,28671193
382,All CA Counties,2021-06-07,140774,40056057,103207,21924189,31295,16678243,6062,1420200,40694,2794058,99036,19237374,46666,22031432,,0,0,28671193
383,All CA Counties,2021-06-08,163059,40219116,118247,22042436,37661,16715904,6968,1427168,47385,2733867,114456,19351830,54265,22085697,,0,0,28671193
384,All CA Counties,2021-06-09,157769,40376885,114690,22157126,35870,16751774,6984,1434152,42473,2669312,113853,19465683,49298,22134995,,0,0,28671193
385,All CA Counties,2021-06-10,151662,40528547,108926,22266052,35021,16786795,7515,1441667,42865,2612037,107538,19573221,50263,22185258,,0,0,28671193
386,All CA Counties,2021-06-11,164948,40693495,115832,22381884,41988,16828783,6935,1448602,50159,2555595,113448,19686669,57006,22242264,,0,0,28671193
387,All CA Counties,2021-06-12,119293,40812788,90333,22472217,24909,16853692,3939,1452541,32872,2506830,85517,19772186,36752,22279016,,0,0,28671193
388,All CA Counties,2021-06-13,46082,40858870,34378,22506595,9527,16863219,2109,1454650,11021,2485275,34654,19806840,13099,22292115,,0,0,28671193
389,All CA Counties,2021-06-14,118874,40977744,84547,22591142,27324,16890543,6807,1461457,38042,2450183,79842,19886682,44750,22336865,,0,0,28671193
390,All CA Counties,2021-06-15,136444,41114188,92116,22683258,35126,16925669,9011,1470468,44778,2413541,90280,19976962,53638,22390503,,0,0,28671193
391,All CA Counties,2021-06-16,125441,41239629,88367,22771625,28995,16954664,7859,1478327,42261,2381603,81924,20058886,49986,22440489,,0,0,28671193
392,All CA Counties,2021-06-17,119789,41359418,82230,22853855,28232,16982896,9134,1487461,41008,2354018,77599,20136485,50014,22490503,,0,0,28671193
393,All CA Counties,2021-06-18,134587,41494005,92948,22946803,33157,17016053,8295,1495756,47190,2323190,86193,20222678,55365,22545868,,0,0,28671193
394,All CA Counties,2021-06-19,79814,41573819,57822,23004625,17493,17033546,4389,1500145,29294,2307066,49754,20272432,33630,22579498,,0,0,28671193
395,All CA Counties,2021-06-20,32282,41606101,24084,23028709,6529,17040075,1613,1501758,11839,2300513,19971,20292403,13418,22592916,,0,0,28671193
396,All CA Counties,2021-06-21,74932,41681033,46761,23075470,21381,17061456,6607,1508365,37500,2307916,36572,20328975,43975,22636891,,0,0,28671193
397,All CA Counties,2021-06-22,104830,41785863,72882,23148352,25334,17086790,6452,1514817,39982,2290458,63797,20392772,46339,22683230,,0,0,28671193
398,All CA Counties,2021-06-23,98021,41883884,68844,23217196,22742,17109532,6235,1521052,39084,2277776,57843,20450615,45161,22728391,,0,0,28671193
399,All CA Counties,2021-06-24,94979,41978863,66070,23283266,22828,17132360,5882,1526934,37725,2265078,56177,20506792,43479,22771870,,0,0,28671193
400,All CA Counties,2021-06-25,109987,42088850,77644,23360910,26599,17158959,5558,1532492,44230,2250127,64658,20571450,49707,22821577,,0,0,28671193
401,All CA Counties,2021-06-26,70798,42159648,53343,23414253,14049,17173008,3259,1535751,28649,2240614,41367,20612817,31854,22853431,,0,0,28671193
402,All CA Counties,2021-06-27,32670,42192318,25108,23439361,5904,17178912,1594,1537345,13612,2237190,18606,20631423,15182,22868613,,0,0,28671193
403,All CA Counties,2021-06-28,74965,42267283,57841,23497202,12344,17191256,4606,1541951,32064,2231898,41879,20673302,36587,22905200,,0,0,28671193
404,All CA Counties,2021-06-29,87564,42354847,62018,23559220,20940,17212196,4477,1546428,36242,2222298,50233,20723535,40633,22945833,,0,0,28671193
405,All CA Counties,2021-06-30,83360,42438207,59616,23618836,19506,17231702,4064,1550492,36597,2217588,45276,20768811,40566,22986399,,0,0,28671193
406,All CA Counties,2021-07-01,78727,42516934,56258,23675094,17987,17249689,4270,1554762,33817,2212172,43391,20812202,37975,23024374,,0,0,28671193
407,All CA Counties,2021-07-02,88594,42605528,63219,23738313,21152,17270841,4096,1558858,38404,2205503,49093,20861295,42424,23066798,,0,0,28671193
408,All CA Counties,2021-07-03,48464,42653992,35255,23773568,11319,17282160,1798,1560656,21640,2202763,26146,20887441,23406,23090204,,0,0,28671193
409,All CA Counties,2021-07-04,3787,42657779,2207,23775775,1237,17283397,291,1560947,1623,2202637,2033,20889474,1907,23092111,,0,0,28671193
410,All CA Counties,2021-07-05,42421,42700200,31323,23807098,9368,17292765,1634,1562581,19316,2201069,22480,20911954,20912,23113023,,0,0,28671193
411,All CA Counties,2021-07-06,90217,42790417,65805,23872903,19958,17312723,4286,1566867,33877,2183897,55259,20967213,38087,23151110,,0,0,28671193
412,All CA Counties,2021-07-07,77066,42867483,55349,23928252,17179,17329902,4374,1571241,31166,2174441,44902,21012115,35446,23186556,,0,0,28671193
413,All CA Counties,2021-07-08,74090,42941573,53081,23981333,16803,17346705,4100,1575341,30145,2165530,43072,21055187,34161,23220717,,0,0,28671193
414,All CA Counties,2021-07-09,86336,43027909,61506,24042839,20002,17366707,4708,1580049,36200,2157157,49168,21104355,40795,23261512,,0,0,28671193
415,All CA Counties,2021-07-10,54169,43082078,40125,24082964,11351,17378058,2604,1582653,23118,2152395,30444,21134799,25682,23287194,,0,0,28671193
416,All CA Counties,2021-07-11,24426,43106504,18228,24101192,5091,17383149,1074,1583727,11124,2151549,13027,21147826,12181,23299375,,0,0,28671193
417,All CA Counties,2021-07-12,68637,43175141,50617,24151809,14200,17397349,3677,1587404,28179,2143616,39721,21187547,31788,23331163,,0,0,28671193
418,All CA Counties,2021-07-13,72846,43247987,51942,24203751,17396,17414745,3379,1590783,32147,2139208,39867,21227414,35459,23366622,,0,0,28671193
419,All CA Counties,2021-07-14,70071,43318058,50210,24253961,16306,17431051,3381,1594164,30601,2134480,38617,21266031,33889,23400511,,0,0,28671193
420,All CA Counties,2021-07-15,70780,43388838,51633,24305594,16011,17447062,2998,1597162,32370,2132186,37599,21303630,35305,23435816,,0,0,28671193
421,All CA Counties,2021-07-16,85973,43474811,62152,24367746,20133,17467195,3548,1600710,40640,2131889,44415,21348045,44118,23479934,,0,0,28671193
422,All CA Counties,2021-07-17,55693,43530504,41082,24408828,12384,17479579,2134,1602844,26525,2131985,28529,21376574,28625,23508559,,0,0,28671193
423,All CA Counties,2021-07-18,26505,43557009,20081,24428909,5315,17484894,1083,1603927,12984,2132809,13230,21389804,14054,23522613,,0,0,28671193
424,All CA Counties,2021-07-19,69760,43626769,51810,24480719,14556,17499450,3266,1607193,33876,2134732,35150,21424954,37073,23559686,,0,0,28671193
425,All CA Counties,2021-07-20,79217,43705986,56358,24537077,19260,17518710,3480,1610673,39722,2139274,38589,21463543,43131,23602817,,0,0,28671193
426,All CA Counties,2021-07-21,77594,43783580,56040,24593117,17756,17536466,3659,1614332,38838,2144112,37574,21501117,42412,23645229,,0,0,28671193
427,All CA Counties,2021-07-22,77617,43861197,55968,24649085,18038,17554504,3487,1617819,40639,2152303,35856,21536973,44047,23689276,,0,0,28671193
428,All CA Counties,2021-07-23,92012,43953209,66017,24715102,21993,17576497,3905,1621724,49459,2164208,41376,21578349,53281,23742557,,0,0,28671193
429,All CA Counties,2021-07-24,56090,44009299,40654,24755756,13301,17589798,2066,1623790,31064,2173045,24263,21602612,33100,23775657,,0,0,28671193
430,All CA Counties,2021-07-25,25506,44034805,18893,24774649,5910,17595708,663,1624453,18351,2185317,6728,21609340,19000,23794657,,0,0,28671193
431,All CA Counties,2021-07-26,71494,44106299,50924,24825573,17109,17612817,3339,1627792,43771,2205718,26642,21635982,47043,23841700,,0,0,28671193
432,All CA Counties,2021-07-27,85066,44191365,61596,24887169,19635,17632452,3673,1631465,48453,2222397,35358,21671340,52037,23893737,,0,0,28671193
433,All CA Counties,2021-07-28,84470,44275835,60722,24947891,19795,17652247,3825,1635290,49193,2241358,33974,21705314,52935,23946672,,0,0,28671193
434,All CA Counties,2021-07-29,81860,44357695,59102,25006993,18950,17671197,3674,1638964,48473,2261371,32061,21737375,52074,23998746,,0,0,28671193
435,All CA Counties,2021-07-30,97159,44454854,69962,25076955,23075,17694272,4011,1642975,56593,2283011,38859,21776234,60499,24059245,,0,0,28671193
436,All CA Counties,2021-07-31,60161,44515015,44369,25121324,13500,17707772,2213,1645188,35394,2297058,23499,21799733,37546,24096791,,0,0,28671193
437,All CA Counties,2021-08-01,30791,44545806,23514,25144838,6355,17714127,834,1646022,19370,2306838,10386,21810119,20166,24116957,,0,0,28671193
438,All CA Counties,2021-08-02,80251,44626057,60191,25205029,16597,17730724,3340,1649362,49707,2330556,29258,21839377,52976,24169933,,0,0,28671193
439,All CA Counties,2021-08-03,90028,44716085,65812,25270841,20016,17750740,4072,1653434,54357,2354681,34207,21873584,58332,24228265,,0,0,28671193
440,All CA Counties,2021-08-04,85043,44801128,62730,25333571,18509,17769249,3683,1657117,51346,2377552,32077,21905661,54948,24283213,,0,0,28671193
441,All CA Counties,2021-08-05,86413,44887541,63765,25397336,18518,17787767,4018,1661135,52119,2400966,32620,21938281,56034,24339247,,0,0,28671193
442,All CA Counties,2021-08-06,105189,44992730,77592,25474928,23218,17810985,4252,1665387,62557,2427067,40629,21978910,66730,24405977,,0,0,28671193
443,All CA Counties,2021-08-07,64263,45056993,48458,25523386,13440,17824425,2299,1667686,38089,2442514,24881,22003791,40328,24446305,,0,0,28671193
444,All CA Counties,2021-08-08,35034,45092027,26454,25549840,7649,17832074,892,1668578,21426,2451914,12903,22016694,22303,24468608,,0,0,28671193
445,All CA Counties,2021-08-09,87978,45180005,67047,25616887,17119,17849193,3699,1672277,51006,2471202,35344,22052038,54632,24523240,,0,0,28671193
446,All CA Counties,2021-08-10,91221,45271226,67443,25684330,19898,17869091,3747,1676024,51924,2489109,37671,22089709,55578,24578818,,0,0,28671193
447,All CA Counties,2021-08-11,83890,45355116,62109,25746439,17831,17886922,3809,1679833,46651,2503846,35631,22125340,50368,24629186,,0,0,28671193
448,All CA Counties,2021-08-12,88915,45444031,63989,25810428,20512,17907434,4298,1684131,49885,2520866,37074,22162414,54094,24683280,,0,0,28671193
449,All CA Counties,2021-08-13,111593,45555624,80757,25891185,26257,17933691,4477,1688608,61587,2539767,47071,22209485,65972,24749252,,1437,1437,28671193
450,All CA Counties,2021-08-14,72627,45628251,53172,25944357,17040,17950731,2363,1690971,38276,2550757,29597,22239082,40587,24789839,,2102,3539,28671193
451,All CA Counties,2021-08-15,40229,45668480,29179,25973536,10118,17960849,899,1691870,20276,2555816,16098,22255180,21157,24810996,,1711,5250,28671193
452,All CA Counties,2021-08-16,96781,45765261,67613,26041149,25358,17986207,3707,1695577,46985,2565874,40545,22295725,50603,24861599,,4260,9510,28671193
453,All CA Counties,2021-08-17,102042,45867303,70929,26112078,26973,18013180,4022,1699599,47520,2573221,44105,22339830,51452,24913051,,4966,14476,28671193
454,All CA Counties,2021-08-18,101551,45968854,70489,26182567,27131,18040311,3795,1703394,45614,2578841,43705,22383535,49325,24962376,,6107,20583,28671193
455,All CA Counties,2021-08-19,101421,46070275,69501,26252068,27627,18067938,4209,1707603,45290,2585453,42782,22426317,49394,25011770,,6752,27335,28671193
456,All CA Counties,2021-08-20,126697,46196972,88257,26340325,34047,18101985,4301,1711904,54882,2589200,55334,22481651,59081,25070851,,8418,35753,28671193
457,All CA Counties,2021-08-21,75901,46272873,55348,26395673,18258,18120243,2209,1714113,32265,2589262,34362,22516013,34424,25105275,,4656,40409,28671193
458,All CA Counties,2021-08-22,41870,46314743,30316,26425989,10697,18130940,811,1714924,18734,2590789,17999,22534012,19526,25124801,,2593,43002,28671193
459,All CA Counties,2021-08-23,105612,46420355,76104,26502093,26043,18156983,3349,1718273,45036,2591943,47163,22581175,48317,25173118,,6959,49961,28671193
460,All CA Counties,2021-08-24,106418,46526773,78123,26580216,24701,18181684,3505,1721778,43936,2590208,49100,22630275,47365,25220483,,7084,57045,28671193
461,All CA Counties,2021-08-25,102172,46628945,75392,26655608,23390,18205074,3265,1725043,42531,2589107,46825,22677100,45724,25266207,,6877,63922,28671193
462,All CA Counties,2021-08-26,103665,46732610,75353,26730961,24526,18229600,3663,1728706,42654,2588208,47118,22724218,46219,25312426,,7465,71387,28671193
463,All CA Counties,2021-08-27,128077,46860687,94698,26825659,29556,18259156,3694,1732400,50230,2580828,61222,22785440,53842,25366268,,9075,80462,28671193
464,All CA Counties,2021-08-28,77545,46938232,58532,26884191,17236,18276392,1735,1734135,30292,2574468,38327,22823767,31967,25398235,,4734,85196,28671193
465,All CA Counties,2021-08-29,42275,46980507,31463,26915654,10191,18286583,582,1734717,16782,2571527,20291,22844058,17350,25415585,,2639,87835,28671193
466,All CA Counties,2021-08-30,101172,47081679,73258,26988912,24559,18311142,3256,1737973,38038,2563508,49238,22893296,41219,25456804,,7682,95517,28671193
467,All CA Counties,2021-08-31,100707,47182386,72276,27061188,25325,18336467,3007,1740980,36675,2554482,48631,22941927,39605,25496409,,8585,104102,28671193
468,All CA Counties,2021-09-01,98152,47280538,69904,27131092,24871,18361338,3191,1744171,37929,2551250,44241,22986168,41009,25537418,,9049,113151,28671193
469,All CA Counties,2021-09-02,94096,47374634,66368,27197460,24612,18385950,3023,1747194,34516,2544829,43886,23030054,37465,25574883,,8796,121947,28671193
470,All CA Counties,2021-09-03,118225,47492859,85197,27282657,29730,18415680,3200,1750394,41870,2530949,58887,23088941,45007,25619890,,9932,131879,28671193
471,All CA Counties,2021-09-04,64111,47556970,48206,27330863,14535,18430215,1311,1751705,23581,2522696,33117,23122058,24864,25644754,,3965,135844,28671193
472,All CA Counties,2021-09-05,37950,47594920,28037,27358900,9525,18439740,356,1752061,15107,2520056,18087,23140145,15447,25660201,,2445,138289,28671193
473,All CA Counties,2021-09-06,19463,47614383,12984,27371884,6112,18445852,307,1752368,7561,2518025,9888,23150033,7857,25668058,,1160,139449,28671193
474,All CA Counties,2021-09-07,99298,47713681,72052,27443936,24155,18470007,2993,1755361,30472,2495416,55996,23206029,33387,25701445,,7040,146489,28671193
475,All CA Counties,2021-09-08,89070,47802751,64354,27508290,21916,18491923,2693,1758054,31946,2485237,44718,23250747,34539,25735984,,6827,153316,28671193
476,All CA Counties,2021-09-09,88698,47891449,62382,27570672,23321,18515244,2891,1760945,31615,2475501,44174,23294921,34438,25770422,,7243,160559,28671193
477,All CA Counties,2021-09-10,108167,47999616,76708,27647380,28178,18543422,3175,1764120,37244,2458816,57017,23351938,40332,25810754,,7903,168462,28671193
478,All CA Counties,2021-09-11,63153,48062769,46588,27693968,15117,18558539,1389,1765509,22303,2447981,34497,23386435,23662,25834416,,3502,171964,28671193
479,All CA Counties,2021-09-12,35222,48097991,25514,27719482,9168,18567707,500,1766009,12959,2442847,18579,23405014,13445,25847861,,1988,173952,28671193
480,All CA Counties,2021-09-13,84241,48182232,58897,27778379,22704,18590411,2539,1768548,28598,2428562,45362,23450376,31077,25878938,,5782,179734,28671193
481,All CA Counties,2021-09-14,80535,48262767,57167,27835546,20561,18610972,2721,1771269,26817,2413777,44247,23494623,29462,25908400,,5407,185141,28671193
482,All CA Counties,2021-09-15,79392,48342159,56431,27891977,19988,18630960,2874,1774143,26693,2399848,43418,23538041,29489,25937889,,5142,190283,28671193
483,All CA Counties,2021-09-16,82585,48424744,57697,27949674,21770,18652730,3040,1777183,27800,2386026,44560,23582601,30738,25968627,,5827,196110,28671193
484,All CA Counties,2021-09-17,96364,48521108,68334,28018008,24641,18677371,3286,1780469,30972,2366945,53239,23635840,34158,26002785,,6721,202831,28671193
485,All CA Counties,2021-09-18,56843,48577951,42345,28060353,13035,18690406,1425,1781894,19314,2356628,31024,23666864,20707,26023492,,3177,206008,28671193
486,All CA Counties,2021-09-19,32596,48610547,23726,28084079,8315,18698721,522,1782416,11131,2350967,17304,23684168,11643,26035135,,1962,207970,28671193
487,All CA Counties,2021-09-20,80003,48690550,56649,28140728,20474,18719195,2756,1785172,26092,2338677,41068,23725236,28778,26063913,,6454,214424,28671193
488,All CA Counties,2021-09-21,74218,48764768,53683,28194411,17658,18736853,2775,1787947,24862,2328667,37554,23762790,27544,26091457,,6224,220648,28671193
489,All CA Counties,2021-09-22,71682,48836450,52476,28246887,17076,18753929,2026,1789973,24536,2319068,36101,23798891,26502,26117959,,5996,226644,28671193
490,All CA Counties,2021-09-23,71890,48908340,52302,28299189,17380,18771309,2121,1792094,23713,2311193,33640,23832531,25765,26143724,,7695,234339,28671193
491,All CA Counties,2021-09-24,108229,49016569,85662,28384851,20021,18791330,2468,1794562,29572,2299240,43939,23876470,31986,26175710,,15891,250230,28671193
492,All CA Counties,2021-09-25,70729,49087298,59525,28444376,9892,18801222,1278,1795840,17182,2293191,24458,23900928,18409,26194119,,13034,263264,28671193
493,All CA Counties,2021-09-26,39690,49126988,34281,28478657,4763,18805985,601,1796441,8616,2288679,13713,23914641,9201,26203320,,7768,271032,28671193
494,All CA Counties,2021-09-27,118278,49245266,99999,28578656,15950,18821935,2233,1798674,25723,2292173,24405,23939046,27899,26231219,,33301,304333,28671193
495,All CA Counties,2021-09-28,129197,49374463,111304,28689960,15173,18837108,2637,1801311,26195,2287732,33199,23972245,28758,26259977,,36567,340900,28671193
496,All CA Counties,2021-09-29,129062,49503525,111022,28800982,15374,18852482,2555,1803866,25319,2281242,34288,24006533,27798,26287775,,37918,378818,28671193
497,All CA Counties,2021-09-30,132046,49635571,113672,28914654,15495,18867977,2785,1806651,25367,2274062,35242,24041775,28062,26315837,,40184,419002,28671193
498,All CA Counties,2021-10-01,147478,49783049,126122,29040776,18357,18886334,2771,1809422,28393,2266037,39090,24080865,31065,26346902,,45544,464546,28671193
499,All CA Counties,2021-10-02,67911,49850960,58370,29099146,8298,18894632,1193,1810615,16213,2261729,21682,24102547,17374,26364276,,17280,481826,28671193
500,All CA Counties,2021-10-03,38136,49889096,32239,29131385,5424,18900056,445,1811060,10014,2259461,12714,24115261,10446,26374722,,8952,490778,28671193
501,All CA Counties,2021-10-04,110821,49999917,98127,29229512,10561,18910617,2032,1813092,23010,2256761,27704,24142965,25004,26399726,,35266,526044,28671193
502,All CA Counties,2021-10-05,111376,50111293,96289,29325801,12875,18923492,2118,1815210,22382,2253677,27522,24170487,24438,26424164,,37155,563199,28671193
503,All CA Counties,2021-10-06,109230,50220523,95358,29421159,11612,18935104,2165,1817375,21989,2250430,27344,24197831,24097,26448261,,37197,600396,28671193
504,All CA Counties,2021-10-07,117517,50338040,102150,29523309,12781,18947885,2485,1819860,23152,2248283,27721,24225552,25574,26473835,,42093,642489,28671193
505,All CA Counties,2021-10-08,143094,50481134,123994,29647303,16144,18964029,2867,1822727,29813,2245866,35037,24260589,32620,26506455,,50082,692571,28671193
506,All CA Counties,2021-10-09,65254,50546388,56073,29703376,7918,18971947,1231,1823958,16102,2243834,19330,24279919,17298,26523753,,18643,711214,28671193
507,All CA Counties,2021-10-10,35535,50581923,29997,29733373,5052,18976999,457,1824415,9471,2242623,11125,24291044,9914,26533667,,9212,720426,28671193
508,All CA Counties,2021-10-11,106836,50688759,92217,29825590,12348,18989347,2196,1826611,23529,2241415,26873,24317917,25665,26559332,,35326,755752,28671193
509,All CA Counties,2021-10-12,106087,50794846,92150,29917740,11406,19000753,2418,1829029,21109,2238433,26443,24344360,23461,26582793,,38346,794098,28671193
510,All CA Counties,2021-10-13,99916,50894762,86369,30004109,11062,19011815,2388,1831417,20643,2236227,25169,24369529,22963,26605756,,35612,829710,28671193
511,All CA Counties,2021-10-14,101054,50995816,86679,30090788,11889,19023704,2393,1833810,20278,2233801,25023,24394552,22597,26628353,,37149,866859,28671193
512,All CA Counties,2021-10-15,127038,51122854,109205,30199993,14973,19038677,2769,1836579,25334,2230424,31413,24425965,28036,26656389,,46281,913140,28671193
513,All CA Counties,2021-10-16,59096,51181950,50529,30250522,7372,19046049,1165,1837744,13729,2228846,16447,24442412,14869,26671258,,19086,932226,28671193
514,All CA Counties,2021-10-17,30320,51212270,25564,30276086,4326,19050375,410,1838154,8132,2228531,8839,24451251,8524,26679782,,8646,940872,28671193
515,All CA Counties,2021-10-18,99665,51311935,84503,30360589,12661,19063036,2415,1840569,20866,2225337,26396,24477647,23202,26702984,,34979,975851,28671193
516,All CA Counties,2021-10-19,95958,51407893,82025,30442614,11666,19074702,2183,1842752,17589,2221330,23717,24501364,19710,26722694,,37525,1013376,28671193
517,All CA Counties,2021-10-20,93402,51501295,78490,30521104,12640,19087342,2180,1844932,17524,2217593,23348,24524712,19611,26742305,,36227,1049603,28671193
518,All CA Counties,2021-10-21,97463,51598758,80401,30601505,14676,19102018,2281,1847213,17668,2213548,23874,24548586,19829,26762134,,38304,1087907,28671193
519,All CA Counties,2021-10-22,162953,51761711,102430,30703935,57171,19159189,3280,1850493,23178,2208988,30202,24578788,25642,26787776,,66217,1154124,28671193
520,All CA Counties,2021-10-23,93108,51854819,50107,30754042,41045,19200234,1910,1852403,13128,2206414,16857,24595645,14283,26802059,,37305,1191429,28671193
521,All CA Counties,2021-10-24,47221,51902040,24446,30778488,22028,19222262,730,1853133,7039,2204964,8822,24604467,7372,26809431,,18614,1210043,28671193
522,All CA Counties,2021-10-25,162729,52064769,81403,30859891,77107,19299369,4131,1857264,20743,2202206,25656,24630123,22898,26832329,,70258,1280301,28671193
523,All CA Counties,2021-10-26,180627,52245396,84312,30944203,91135,19390504,5083,1862347,20897,2199955,25499,24655622,23248,26855577,,83557,1363858,28671193
524,All CA Counties,2021-10-27,183704,52429100,83296,31027499,94896,19485400,5426,1867773,20877,2197962,25174,24680796,23181,26878758,,87722,1451580,28671193
525,All CA Counties,2021-10-28,183703,52612803,81361,31108860,96637,19582037,5597,1873370,19531,2193897,25969,24706765,21904,26900662,,89328,1540908,28671193
526,All CA Counties,2021-10-29,220786,52833589,100604,31209464,113567,19695604,6500,1879870,23298,2188901,30867,24737632,25871,26926533,,109413,1650321,28671193
527,All CA Counties,2021-10-30,103803,52937392,48083,31257547,52385,19747989,3290,1883160,12401,2186462,16170,24753802,13731,26940264,,49970,1700291,28671193
528,All CA Counties,2021-10-31,50636,52988028,24397,31281944,25056,19773045,1147,1884307,6808,2184917,8909,24762711,7364,26947628,,23036,1723327,28671193
529,All CA Counties,2021-11-01,180364,53168392,80565,31362509,93516,19866561,6076,1890383,21593,2181995,27372,24790083,24450,26972078,,87555,1810882,28671193
530,All CA Counties,2021-11-02,190188,53358580,84087,31446596,100003,19966564,6003,1896386,21264,2180277,25642,24815725,23924,26996002,,98195,1909077,28671193
531,All CA Counties,2021-11-03,190172,53548752,86413,31533009,97649,20064213,5990,1902376,24934,2183092,24778,24840503,27593,27023595,,97725,2006802,28671193
532,All CA Counties,2021-11-04,198693,53747445,93502,31626511,98865,20163078,6213,1908589,30525,2191481,24874,24865377,33263,27056858,,101221,2108023,28671193
533,All CA Counties,2021-11-05,245625,53993070,120899,31747410,117578,20280656,6979,1915568,43452,2206809,31272,24896649,46600,27103458,,121688,2229711,28671193
534,All CA Counties,2021-11-06,128796,54121866,74360,31821770,51067,20331723,3310,1918878,38648,2231386,15492,24912141,40069,27143527,,53197,2282908,28671193
535,All CA Counties,2021-11-07,67751,54189617,40016,31861786,26245,20357968,1451,1920329,21528,2244716,8921,24921062,22251,27165778,,26417,2309325,28671193
536,All CA Counties,2021-11-08,200944,54390561,107912,31969698,87159,20445127,5750,1926079,52837,2275005,25351,24946413,55640,27221418,,88430,2397755,28671193
537,All CA Counties,2021-11-09,218345,54608906,117083,32086781,94971,20540098,6165,1932244,58485,2312715,23496,24969909,61206,27282624,,100161,2497916,28671193
538,All CA Counties,2021-11-10,228668,54837574,125387,32212168,97107,20637205,6044,1938288,66365,2359123,22379,24992288,68787,27351411,,104064,2601980,28671193
539,All CA Counties,2021-11-11,220084,55057658,124623,32336791,89950,20727155,5393,1943681,67420,2408087,20612,25012900,69576,27420987,,97261,2699241,28671193
540,All CA Counties,2021-11-12,262179,55319837,142007,32478798,113511,20840666,6532,1950213,69378,2453112,26939,25039839,71964,27492951,,123202,2822443,28671193
541,All CA Counties,2021-11-13,150551,55470388,93346,32572144,53958,20894624,3197,1953410,55133,2495809,13637,25053476,56334,27549285,,60189,2882632,28671193
542,All CA Counties,2021-11-14,71414,55541802,42517,32614661,27465,20922089,1410,1954820,21839,2511093,7175,25060651,22459,27571744,,30784,2913416,28671193
543,All CA Counties,2021-11-15,207448,55749250,111302,32725963,90288,21012377,5742,1960562,47220,2538394,22371,25083022,49672,27621416,,102739,3016155,28671193
544,All CA Counties,2021-11-16,227194,55976444,121791,32847754,99267,21111644,6002,1966564,49937,2568244,22513,25105535,52363,27673779,,116128,3132283,28671193
545,All CA Counties,2021-11-17,232361,56208805,127546,32975300,98724,21210368,5965,1972529,53602,2602024,22164,25127699,55944,27729723,,118465,3250748,28671193
546,All CA Counties,2021-11-18,229622,56438427,125157,33100457,98600,21308968,5711,1978240,49263,2631905,21526,25149225,51407,27781130,,121351,3372099,28671193
547,All CA Counties,2021-11-19,272286,56710713,148376,33248833,117513,21426481,6238,1984478,60440,2670166,24472,25173697,62733,27843863,,143137,3515236,28671193
548,All CA Counties,2021-11-20,158978,56869691,94794,33343627,60212,21486693,3914,1988392,45326,2703983,13141,25186838,46958,27890821,,76767,3592003,28671193
549,All CA Counties,2021-11-21,74459,56944150,42664,33386291,30348,21517041,1402,1989794,17723,2715379,6913,25193751,18309,27909130,,37456,3629459,28671193
550,All CA Counties,2021-11-22,233961,57178111,129639,33515930,98568,21615609,5644,1995438,49855,2745202,22180,25215931,52003,27961133,,124934,3754393,28671193
551,All CA Counties,2021-11-23,244794,57422905,137413,33653343,101378,21716987,5866,2001304,51444,2775971,22831,25238762,53600,28014733,,133179,3887572,28671193
552,All CA Counties,2021-11-24,205227,57628132,117550,33770893,82027,21799014,5530,2006834,43569,2798932,22691,25261453,45652,28060385,,109516,3997088,28671193
553,All CA Counties,2021-11-25,4940,57633072,2587,33773480,2068,21801082,253,2007087,868,2798873,1061,25262514,1002,28061387,,2458,3999546,28671193
554,All CA Counties,2021-11-26,152767,57785839,90311,33863791,59348,21860430,3056,2010143,26853,2803117,23766,25286280,28010,28089397,,79572,4079118,28671193
555,All CA Counties,2021-11-27,114778,57900617,70743,33934534,41735,21902165,2267,2012410,18391,2796794,25515,25311795,19192,28108589,,55564,4134682,28671193
556,All CA Counties,2021-11-28,64540,57965157,39486,33974020,23882,21926047,1141,2013551,9429,2790247,16463,25328258,9916,28118505,,30195,4164877,28671193
557,All CA Counties,2021-11-29,215463,58180620,130144,34104164,79978,22006025,5248,2018799,29492,2770416,51418,25379676,31587,28150092,,108343,4273220,28671193
558,All CA Counties,2021-11-30,248796,58429416,150664,34254828,91570,22097595,6405,2025204,34747,2752797,54736,25434412,37117,28187209,,129931,4403151,28671193
559,All CA Counties,2021-12-01,277267,58706683,163703,34418531,107237,22204832,6106,2031310,39987,2736010,59122,25493534,42335,28229544,,146232,4549383,28671193
560,All CA Counties,2021-12-02,281127,58987810,162621,34581152,111831,22316663,6541,2037851,38216,2719719,56758,25550292,40467,28270011,,155660,4705043,28671193
561,All CA Counties,2021-12-03,321835,59309645,190631,34771783,124429,22441092,6572,2044423,43394,2694701,70662,25620954,45644,28315655,,173913,4878956,28671193
562,All CA Counties,2021-12-04,186584,59496229,123441,34895224,59817,22500909,3263,2047686,27191,2667222,55778,25676732,28299,28343954,,86900,4965856,28671193
563,All CA Counties,2021-12-05,83889,59580118,53500,34948724,28963,22529872,1388,2049074,12505,2657696,22592,25699324,13066,28357020,,40853,5006709,28671193
564,All CA Counties,2021-12-06,242953,59823071,142795,35091519,94375,22624247,5648,2054722,34326,2648298,45680,25745004,36282,28393302,,137916,5144625,28671193
565,All CA Counties,2021-12-07,261177,60084248,154438,35245957,100806,22725053,5741,2060463,36885,2639164,48048,25793052,38914,28432216,,150369,5294994,28671193
566,All CA Counties,2021-12-08,262166,60346414,159100,35405057,97185,22822238,5735,2066198,37883,2627599,51546,25844598,39981,28472197,,148468,5443462,28671193
567,All CA Counties,2021-12-09,254387,60600801,153414,35558471,95600,22917838,5217,2071415,36368,2620159,45702,25890300,38262,28510459,,148025,5591487,28671193
568,All CA Counties,2021-12-10,283937,60884738,170242,35728713,107995,23025833,5538,2076953,38137,2603784,56381,25946681,40006,28550465,,163098,5754585,28671193
569,All CA Counties,2021-12-11,164227,61048965,108547,35837260,52856,23078689,2774,2079727,24963,2587788,42010,25988691,26014,28576479,,84269,5838854,28671193
570,All CA Counties,2021-12-12,71825,61120790,44601,35881861,26043,23104732,1159,2080886,10837,2584110,15011,26003702,11333,28587812,,39518,5878372,28671193
571,All CA Counties,2021-12-13,217736,61338526,131183,36013044,82131,23186863,4296,2085182,29839,2576233,39309,26043011,31432,28619244,,129201,6007573,28671193
572,All CA Counties,2021-12-14,228632,61567158,139626,36152670,84241,23271104,4615,2089797,31540,2569590,39923,26082934,33280,28652524,,137709,6145282,28671193
573,All CA Counties,2021-12-15,235437,61802595,142479,36295149,88051,23359155,4729,2094526,33271,2566124,38602,26121536,35136,28687660,,143551,6288833,28671193
574,All CA Counties,2021-12-16,229850,62032445,135211,36430360,90084,23449239,4408,2098934,35477,2580991,22290,26143826,37157,28724817,,151445,6440278,28671193
575,All CA Counties,2021-12-17,263271,62295716,156187,36586547,103196,23552435,3743,2102677,40354,2586975,35871,26179697,41855,28766672,,164984,6605262,28671193
576,All CA Counties,2021-12-18,146410,62442126,92476,36679023,52226,23604661,1672,2104349,25097,2589872,22822,26202519,25719,28792391,,87629,6692891,28671193
577,All CA Counties,2021-12-19,73282,62515408,44916,36723939,27673,23632334,676,2105025,12337,2593324,9182,26211701,12634,28805025,,46079,6738970,28671193
578,All CA Counties,2021-12-20,247923,62763331,149064,36873003,95487,23727821,3217,2108242,39034,2601614,32144,26243845,40434,28845459,,158218,6897188,28671193
579,All CA Counties,2021-12-21,266168,63029499,159015,37032018,103656,23831477,3334,2111576,41282,2611201,33011,26276856,42598,28888057,,172636,7069824,28671193
580,All CA Counties,2021-12-22,257633,63287132,155514,37187532,98864,23930341,3127,2114703,39259,2617950,33788,26310644,40537,28928594,,166885,7236709,28671193
581,All CA Counties,2021-12-23,218774,63505906,132576,37320108,83497,24013838,2607,2117310,32900,2625060,26779,26337423,33889,28962483,,144463,7381172,28671193
582,All CA Counties,2021-12-24,45946,63551852,28629,37348737,16594,24030432,697,2118007,6794,2625169,7011,26344434,7120,28969603,,29210,7410382,28671193
583,All CA Counties,2021-12-25,1024,63552876,578,37349315,425,24030857,12,2118019,259,2625309,125,26344559,265,28969868,,566,7410948,28671193
584,All CA Counties,2021-12-26,56032,63608908,33113,37382428,22458,24053315,444,2118463,9550,2625144,9945,26354504,9780,28979648,,33141,7444089,28671193
585,All CA Counties,2021-12-27,213620,63822528,130577,37513005,80458,24133773,2490,2120953,33861,2627458,32592,26387096,34906,29014554,,135178,7579267,28671193
586,All CA Counties,2021-12-28,244055,64066583,150927,37663932,90263,24224036,2791,2123744,40298,2634158,34731,26421827,41431,29055985,,155862,7735129,28671193
587,All CA Counties,2021-12-29,243705,64310288,150471,37814403,89918,24313954,3210,2126954,41749,2643762,33383,26455210,42987,29098972,,156375,7891504,28671193
588,All CA Counties,2021-12-30,224510,64534798,138077,37952480,83212,24397166,3129,2130083,38660,2653440,30098,26485308,39776,29138748,,144314,8035818,28671193
589,All CA Counties,2021-12-31,75250,64610048,44938,37997418,29127,24426293,1144,2131227,12560,2655823,10600,26495908,12983,29151731,,48269,8084087,28671193
590,All CA Counties,2022-01-01,9135,64619183,5560,38002978,3323,24429616,201,2131428,2069,2656566,1401,26497309,2144,29153875,,4868,8088955,28671193
591,All CA Counties,2022-01-02,54092,64673275,33548,38036526,19988,24449604,542,2131970,9592,2656953,9406,26506715,9793,29163668,,32668,8121623,28671193
592,All CA Counties,2022-01-03,203237,64876512,124013,38160539,76064,24525668,3025,2134995,36398,2664134,30450,26537165,37631,29201299,,127338,8248961,28671193
593,All CA Counties,2022-01-04,219944,65096456,136774,38297313,79732,24605400,3297,2138292,39515,2674621,30188,26567353,40675,29241974,,140692,8389653,28671193
594,All CA Counties,2022-01-05,224510,65320966,139938,38437251,81138,24686538,3263,2141555,41141,2687098,29782,26597135,42259,29284233,,144103,8533756,28671193
595,All CA Counties,2022-01-06,234687,65555653,150583,38587834,80662,24767200,3278,2144833,41571,2698566,31221,26628356,42689,29326922,,150162,8683918,28671193
596,All CA Counties,2022-01-07,273691,65829344,173357,38761191,96385,24863585,3784,2148617,46602,2708848,37569,26665925,47851,29374773,,175922,8859840,28671193
597,All CA Counties,2022-01-08,153023,65982367,105659,38866850,45600,24909185,1716,2150333,29297,2716093,22661,26688586,29906,29404679,,92930,8952770,28671193
598,All CA Counties,2022-01-09,63518,66045885,41241,38908091,21581,24930766,674,2151007,12075,2720155,8301,26696887,12363,29417042,,39904,8992674,28671193
599,All CA Counties,2022-01-10,192215,66238100,120371,39028462,68740,24999506,2874,2153881,34021,2728574,26693,26723580,35112,29452154,,122646,9115320,28671193
600,All CA Counties,2022-01-11,203756,66441856,133070,39161532,67427,25066933,3076,2156957,35983,2737983,27654,26751234,37063,29489217,,130252,9245572,28671193
601,All CA Counties,2022-01-12,200696,66642552,132211,39293743,65282,25132215,2995,2159952,36145,2748193,27019,26778253,37229,29526446,,128208,9373780,28671193
602,All CA Counties,2022-01-13,193652,66836204,127137,39420880,63374,25195589,2941,2162893,35059,2759518,24835,26803088,36160,29562606,,125300,9499080,28671193
603,All CA Counties,2022-01-14,227232,67063436,145800,39566680,78060,25273649,3234,2166127,41209,2779106,22747,26825835,42335,29604941,,153013,9652093,28671193
604,All CA Counties,2022-01-15,118984,67182420,82395,39649075,34982,25308631,1545,2167672,24259,2792406,11493,26837328,24793,29629734,,77438,9729531,28671193
605,All CA Counties,2022-01-16,55337,67237757,36762,39685837,17983,25326614,569,2168241,10977,2797208,6395,26843723,11197,29640931,,35487,9765018,28671193
606,All CA Counties,2022-01-17,140797,67378554,94906,39780743,43752,25370366,1940,2170181,25143,2804561,18555,26862278,25908,29666839,,90551,9855569,28671193
607,All CA Counties,2022-01-18,164571,67543125,111335,39892078,50547,25420913,2474,2172655,28760,2808730,25534,26887812,29703,29696542,,103383,9958952,28671193
608,All CA Counties,2022-01-19,163031,67706156,109876,40001954,50395,25471308,2510,2175165,28430,2812193,25831,26913643,29294,29725836,,102177,10061129,28671193
609,All CA Counties,2022-01-20,156218,67862374,105203,40107157,48373,25519681,2435,2177600,27430,2816064,24369,26938012,28240,29754076,,98048,10159177,28671193
610,All CA Counties,2022-01-21,185307,68047681,123044,40230201,59264,25578945,2816,2180416,33449,2828740,21710,26959722,34386,29788462,,122450,10281627,28671193
611,All CA Counties,2022-01-22,97845,68145526,68044,40298245,28553,25607498,1179,2181595,19784,2838779,10120,26969842,20159,29808621,,63857,10345484,28671193
612,All CA Counties,2022-01-23,44999,68190525,30986,40329231,13431,25620929,561,2182156,8827,2841253,6593,26976435,9067,29817688,,27862,10373346,28671193
613,All CA Counties,2022-01-24,135141,68325666,91733,40420964,41041,25661970,2193,2184349,23103,2843365,21770,26998205,23882,29841570,,85067,10458413,28671193
614,All CA Counties,2022-01-25,136017,68461683,95031,40515995,38658,25700628,2157,2186506,22892,2841977,25048,27023253,23660,29865230,,82954,10541367,28671193
615,All CA Counties,2022-01-26,135571,68597254,95289,40611284,37871,25738499,2254,2188760,22671,2839306,26127,27049380,23456,29888686,,81629,10622996,28671193
616,All CA Counties,2022-01-27,135356,68732610,94564,40705848,38370,25776869,2249,2191009,22543,2836858,25695,27075075,23247,29911933,,82332,10705328,28671193
617,All CA Counties,2022-01-28,170425,68903035,120085,40825933,47761,25824630,2427,2193436,28214,2833869,31978,27107053,28989,29940922,,104060,10809388,28671193
618,All CA Counties,2022-01-29,91874,68994909,68113,40894046,22593,25847223,1125,2194561,16979,2832540,18697,27125750,17368,29958290,,52950,10862338,28671193
619,All CA Counties,2022-01-30,38080,69032989,27496,40921542,10049,25857272,523,2195084,7195,2832615,7354,27133104,7429,29965719,,22317,10884655,28671193
620,All CA Counties,2022-01-31,111653,69144642,78562,41000104,31128,25888400,1858,2196942,19174,2830221,22230,27155334,19836,29985555,,66159,10950814,28671193
621,All CA Counties,2022-02-01,102093,69246735,72187,41072291,28092,25916492,1656,2198598,17564,2826433,22021,27177355,18233,30003788,,58322,11009136,28671193
622,All CA Counties,2022-02-02,99520,69346255,71382,41143673,26564,25943056,1432,2200030,18086,2821762,23379,27200734,18708,30022496,,54365,11063501,28671193
623,All CA Counties,2022-02-03,96189,69442444,68009,41211682,26572,25969628,1484,2201514,17545,2817927,22035,27222769,18200,30040696,,53113,11116614,28671193
624,All CA Counties,2022-02-04,127315,69569759,91916,41303598,33694,26003322,1605,2203119,22414,2810593,30422,27253191,23088,30063784,,69856,11186470,28671193
625,All CA Counties,2022-02-05,69586,69639345,52523,41356121,16250,26019572,771,2203890,13567,2807332,17154,27270345,13893,30077677,,36496,11222966,28671193
626,All CA Counties,2022-02-06,30739,69670084,22531,41378652,7917,26027489,277,2204167,6266,2806912,6820,27277165,6400,30084077,,16592,11239558,28671193
627,All CA Counties,2022-02-07,81029,69751113,56872,41435524,22792,26050281,1252,2205419,16168,2804930,18786,27295951,16804,30100881,,42724,11282282,28671193
628,All CA Counties,2022-02-08,78679,69829792,56025,41491549,21284,26071565,1257,2206676,14688,2800478,19732,27315683,15280,30116161,,41101,11323383,28671193
629,All CA Counties,2022-02-09,79224,69909016,56831,41548380,21044,26092609,1206,2207882,15173,2795885,20308,27335991,15715,30131876,,40548,11363931,28671193
630,All CA Counties,2022-02-10,75746,69984762,53452,41601832,20921,26113530,1233,2209115,13984,2791071,19329,27355320,14515,30146391,,39212,11403143,28671193
631,All CA Counties,2022-02-11,99236,70083998,71814,41673646,26033,26139563,1287,2210402,18013,2784789,24855,27380175,18573,30164964,,52355,11455498,28671193
632,All CA Counties,2022-02-12,52451,70136449,39721,41713367,12074,26151637,621,2211023,10327,2781835,13567,27393742,10613,30175577,,26547,11482045,28671193
633,All CA Counties,2022-02-13,19844,70156293,14769,41728136,4864,26156501,204,2211227,4016,2781062,4893,27398635,4120,30179697,,10113,11492158,28671193
634,All CA Counties,2022-02-14,52238,70208531,37588,41765724,13728,26170229,813,2212040,9655,2777628,13462,27412097,10028,30189725,,26402,11518560,28671193
635,All CA Counties,2022-02-15,59386,70267917,42149,41807873,16163,26186392,965,2213005,10669,2772667,16065,27428162,11104,30200829,,29734,11548294,28671193
636,All CA Counties,2022-02-16,61444,70329361,44012,41851885,16341,26202733,960,2213965,11504,2768105,16552,27444714,11990,30212819,,30683,11578977,28671193
637,All CA Counties,2022-02-17,62588,70391949,44477,41896362,16954,26219687,1025,2214990,11596,2764096,16044,27460758,12035,30224854,,32054,11611031,28671193
638,All CA Counties,2022-02-18,86349,70478298,63113,41959475,21908,26241595,1184,2216174,15605,2758442,21798,27482556,16144,30240998,,44911,11655942,28671193
639,All CA Counties,2022-02-19,45837,70524135,35066,41994541,10290,26251885,464,2216638,9200,2756123,11734,27494290,9415,30250413,,23144,11679086,28671193
640,All CA Counties,2022-02-20,21868,70546003,16304,42010845,5338,26257223,210,2216848,4539,2755555,5223,27499513,4655,30255068,,11086,11690172,28671193
641,All CA Counties,2022-02-21,43054,70589057,30826,42041671,11406,26268629,702,2217550,7810,2752646,11025,27510538,8116,30263184,,22022,11712194,28671193
642,All CA Counties,2022-02-22,55866,70644923,40244,42081915,14487,26283116,1003,2218553,9776,2748543,14314,27524852,10211,30273395,,28824,11741018,28671193
643,All CA Counties,2022-02-23,55014,70699937,39856,42121771,14083,26297199,966,2219519,9779,2745065,13670,27538522,10192,30283587,,28947,11769965,28671193
644,All CA Counties,2022-02-24,55791,70755728,39824,42161595,14778,26311977,1089,2220608,10048,2742634,12918,27551440,10487,30294074,,30170,11800135,28671193
645,All CA Counties,2022-02-25,75941,70831669,55091,42216686,19577,26331554,1215,2221823,13325,2738619,17828,27569268,13813,30307887,,41531,11841666,28671193
646,All CA Counties,2022-02-26,40323,70871992,30531,42247217,9199,26340753,571,2222394,8069,2737337,9572,27578840,8290,30316177,,21193,11862859,28671193
647,All CA Counties,2022-02-27,20207,70892199,14963,42262180,4985,26345738,247,2222641,4165,2737429,4188,27583028,4280,30320457,,11075,11873934,28671193
648,All CA Counties,2022-02-28,59522,70951721,41662,42303842,16443,26362181,1321,2223962,9190,2735030,12006,27595034,9607,30330064,,35738,11909672,28671193
649,All CA Counties,2022-03-01,50610,71002331,35324,42339166,14133,26376314,1057,2225019,8523,2733135,10803,27605837,8908,30338972,,28328,11938000,28671193
650,All CA Counties,2022-03-02,44438,71046769,31979,42371145,11582,26387896,778,2225797,8562,2731107,10938,27616775,8910,30347882,,22605,11960605,28671193
651,All CA Counties,2022-03-03,41519,71088288,29465,42400610,11195,26399091,739,2226536,7946,2729385,10000,27626775,8278,30356160,,21158,11981763,28671193
652,All CA Counties,2022-03-04,55977,71144265,40762,42441372,14344,26413435,788,2227324,10844,2726459,14138,27640913,11212,30367372,,27777,12009540,28671193
653,All CA Counties,2022-03-05,29709,71173974,22656,42464028,6681,26420116,362,2227686,6392,2725568,7460,27648373,6569,30373941,,14568,12024108,28671193
654,All CA Counties,2022-03-06,13517,71187491,10196,42474224,3175,26423291,141,2227827,3311,2725990,2976,27651349,3398,30377339,,6579,12030687,28671193
655,All CA Counties,2022-03-07,35183,71222674,24744,42498968,9753,26433044,595,2228422,6875,2725206,7958,27659307,7174,30384513,,18076,12048763,28671193
656,All CA Counties,2022-03-08,34205,71256879,24178,42523146,9392,26442436,550,2228972,6766,2724232,8032,27667339,7058,30391571,,17199,12065962,28671193
657,All CA Counties,2022-03-09,36061,71292940,25862,42549008,9425,26451861,658,2229630,7602,2723416,8753,27676092,7937,30399508,,17549,12083511,28671193
658,All CA Counties,2022-03-10,34473,71327413,24905,42573913,8877,26460738,570,2230200,6726,2721907,8545,27684637,7036,30406544,,16968,12100479,28671193
659,All CA Counties,2022-03-11,43946,71371359,32735,42606648,10480,26471218,627,2230827,8396,2719689,10902,27695539,8684,30415228,,22068,12122547,28671193
660,All CA Counties,2022-03-12,25641,71397000,19565,42626213,5718,26476936,337,2231164,5531,2719013,6373,27701912,5697,30420925,,12513,12135060,28671193
661,All CA Counties,2022-03-13,11985,71408985,9167,42635380,2654,26479590,156,2231320,2840,2719229,2710,27704622,2926,30423851,,5900,12140960,28671193
662,All CA Counties,2022-03-14,31041,71440026,22181,42657561,8154,26487744,609,2231929,6176,2719379,6341,27710963,6491,30430342,,16357,12157317,28671193
663,All CA Counties,2022-03-15,31913,71471939,22707,42680268,8608,26496352,510,2232439,6129,2718854,6898,27717861,6373,30436715,,16374,12173691,28671193
664,All CA Counties,2022-03-16,32043,71503982,22652,42702920,8775,26505127,499,2232938,6204,2718150,7148,27725009,6444,30443159,,15944,12189635,28671193
665,All CA Counties,2022-03-17,31133,71535115,22008,42724928,8487,26513614,552,2233490,5890,2717528,6791,27731800,6169,30449328,,15624,12205259,28671193
666,All CA Counties,2022-03-18,43179,71578294,31289,42756217,11176,26524790,634,2234124,8413,2716500,9745,27741545,8717,30458045,,21122,12226381,28671193
667,All CA Counties,2022-03-19,23866,71602160,18044,42774261,5511,26530301,291,2234415,5251,2716389,5521,27747066,5410,30463455,,11185,12237566,28671193
668,All CA Counties,2022-03-20,11409,71613569,8410,42782671,2843,26533144,149,2234564,2638,2716833,2291,27749357,2735,30466190,,5434,12243000,28671193
669,All CA Counties,2022-03-21,31330,71644899,22424,42805095,8296,26541440,530,2235094,6366,2717087,6393,27755750,6647,30472837,,15394,12258394,28671193
670,All CA Counties,2022-03-22,29021,71673920,20352,42825447,8127,26549567,461,2235555,5518,2716764,6080,27761830,5757,30478594,,14521,12272915,28671193
671,All CA Counties,2022-03-23,29998,71703918,21178,42846625,8223,26557790,459,2236014,5508,2716021,6502,27768332,5759,30484353,,14892,12287807,28671193
672,All CA Counties,2022-03-24,28934,71732852,20344,42866969,8007,26565797,472,2236486,5525,2715642,6156,27774488,5777,30490130,,14343,12302150,28671193
673,All CA Counties,2022-03-25,37199,71770051,27164,42894133,9395,26575192,556,2237042,7359,2714795,8482,27782970,7635,30497765,,18057,12320207,28671193
674,All CA Counties,2022-03-26,19538,71789589,14583,42908716,4703,26579895,245,2237287,4068,2714548,4450,27787420,4203,30501968,,9272,12329479,28671193
675,All CA Counties,2022-03-27,10033,71799622,7278,42915994,2619,26582514,130,2237417,2072,2714645,2049,27789469,2146,30504114,,4811,12334290,28671193
676,All CA Counties,2022-03-28,26043,71825665,18238,42934232,7277,26589791,468,2237885,4744,2714426,5208,27794677,4989,30509103,,12885,12347175,28671193
677,All CA Counties,2022-03-29,31832,71857497,21328,42955560,9880,26599671,555,2238440,5078,2714413,5382,27800059,5369,30514472,,13308,12360483,28671193
678,All CA Counties,2022-03-30,61144,71918641,35565,42991125,24988,26624659,504,2238944,5579,2713809,6461,27806520,5857,30520329,,14814,12375297,28671193
679,All CA Counties,2022-03-31,73215,71991856,40251,43031376,32441,26657100,446,2239390,5597,2713230,6407,27812927,5828,30526157,,14243,12389540,28671193
680,All CA Counties,2022-04-01,92075,72083931,51492,43082868,39992,26697092,508,2239898,7083,2712294,8266,27821193,7330,30533487,,17301,12406841,28671193
681,All CA Counties,2022-04-02,49173,72133104,27980,43110848,20931,26718023,248,2240146,4137,2712210,4370,27825563,4286,30537773,,8563,12415404,28671193
682,All CA Counties,2022-04-03,28216,72161320,15573,43126421,12517,26730540,122,2240268,2204,2712374,2110,27827673,2274,30540047,,4567,12419971,28671193
683,All CA Counties,2022-04-04,81409,72242729,43467,43169888,37477,26768017,393,2240661,5016,2711824,5761,27833434,5211,30545258,,12720,12432691,28671193
684,All CA Counties,2022-04-05,80704,72323433,43439,43213327,36696,26804713,483,2241144,5315,2711574,5820,27839254,5570,30550828,,13247,12445938,28671193
685,All CA Counties,2022-04-06,80049,72403482,43901,43257228,35644,26840357,421,2241565,5425,2711269,5960,27845214,5655,30556483,,12836,12458774,28671193
686,All CA Counties,2022-04-07,80273,72483755,43607,43300835,36246,26876603,355,2241920,5108,2711138,5442,27850656,5311,30561794,,12412,12471186,28671193
687,All CA Counties,2022-04-08,92237,72575992,50892,43351727,40831,26917434,433,2242353,6104,2710350,7109,27857765,6321,30568115,,14592,12485778,28671193
688,All CA Counties,2022-04-09,46590,72622582,26370,43378097,20008,26937442,199,2242552,3741,2710382,3829,27861594,3861,30571976,,7750,12493528,28671193
689,All CA Counties,2022-04-10,26604,72649186,14847,43392944,11638,26949080,106,2242658,2410,2710794,2066,27863660,2478,30574454,,4321,12497849,28671193
690,All CA Counties,2022-04-11,81391,72730577,44503,43437447,36414,26985494,409,2243067,5524,2711095,5462,27869122,5763,30580217,,12760,12510609,28671193
691,All CA Counties,2022-04-12,84214,72814791,45583,43483030,38115,27023609,444,2243511,5747,2711545,5531,27874653,5981,30586198,,12740,12523349,28671193
692,All CA Counties,2022-04-13,80716,72895507,44482,43527512,35734,27059343,421,2243932,5968,2712198,5559,27880212,6212,30592410,,12879,12536228,28671193
693,All CA Counties,2022-04-14,78494,72974001,43407,43570919,34685,27094028,339,2244271,5448,2712446,5387,27885599,5635,30598045,,12292,12548520,28671193
694,All CA Counties,2022-04-15,85502,73059503,47663,43618582,37358,27131386,422,2244693,6295,2712312,6667,27892266,6533,30604578,,14273,12562793,28671193
695,All CA Counties,2022-04-16,39423,73098926,22800,43641382,16388,27147774,222,2244915,3517,2712693,3256,27895522,3637,30608215,,7233,12570026,28671193
696,All CA Counties,2022-04-17,9913,73108839,6130,43647512,3715,27151489,63,2244978,1346,2713186,885,27896407,1378,30609593,,1970,12571996,28671193
697,All CA Counties,2022-04-18,75346,73184185,41173,43688685,33722,27185211,375,2245353,5330,2713631,5089,27901496,5534,30615127,,11797,12583793,28671193
698,All CA Counties,2022-04-19,75163,73259348,41372,43730057,33294,27218505,412,2245765,5343,2714182,5006,27906502,5557,30620684,,11704,12595497,28671193
699,All CA Counties,2022-04-20,71790,73331138,39299,43769356,32019,27250524,375,2246140,5087,2714504,4983,27911485,5305,30625989,,11256,12606753,28671193
700,All CA Counties,2022-04-21,70799,73401937,39350,43808706,30954,27281478,382,2246522,5403,2715158,4980,27916465,5634,30631623,,10991,12617744,28671193
701,All CA Counties,2022-04-22,65030,73466967,36513,43845219,28056,27309534,373,2246895,4905,2714956,5301,27921766,5099,30636722,,10789,12628533,28671193
702,All CA Counties,2022-04-23,37127,73504094,21445,43866664,15493,27325027,172,2247067,3333,2715130,3268,27925034,3442,30640164,,6522,12635055,28671193
703,All CA Counties,2022-04-24,18301,73522395,10419,43877083,7803,27332830,76,2247143,1787,2715351,1616,27926650,1837,30642001,,3350,12638405,28671193
704,All CA Counties,2022-04-25,63546,73585941,34669,43911752,28421,27361251,361,2247504,4548,2715734,4379,27931029,4762,30646763,,10292,12648697,28671193
705,All CA Counties,2022-04-26,63908,73649849,34711,43946463,28764,27390015,355,2247859,4656,2716034,4529,27935558,4829,30651592,,10273,12658970,28671193
706,All CA Counties,2022-04-27,64637,73714486,35515,43981978,28728,27418743,308,2248167,4720,2716167,4753,27940311,4886,30656478,,10839,12669809,28671193
707,All CA Counties,2022-04-28,65117,73779603,35585,44017563,29064,27447807,372,2248539,4841,2716676,4544,27944855,5053,30661531,,10652,12680461,28671193
708,All CA Counties,2022-04-29,75588,73855191,41831,44059394,33304,27481111,377,2248916,5688,2716524,6069,27950924,5917,30667448,,12716,12693177,28671193
709,All CA Counties,2022-04-30,34308,73889499,20001,44079395,14134,27495245,160,2249076,3147,2716784,2977,27953901,3237,30670685,,6490,12699667,28671193
710,All CA Counties,2022-05-01,17897,73907396,10323,44089718,7466,27502711,98,2249174,1965,2717221,1592,27955493,2029,30672714,,3439,12703106,28671193
711,All CA Counties,2022-05-02,57771,73965167,31713,44121431,25697,27528408,299,2249473,4753,2717823,4318,27959811,4920,30677634,,9800,12712906,28671193
712,All CA Counties,2022-05-03,58124,74023291,31231,44152662,26511,27554919,312,2249785,4377,2718019,4372,27964183,4568,30682202,,9625,12722531,28671193
713,All CA Counties,2022-05-04,58294,74081585,31949,44184611,25968,27580887,302,2250087,4399,2718229,4375,27968558,4585,30686787,,9926,12732457,28671193
714,All CA Counties,2022-05-05,58377,74139962,31640,44216251,26318,27607205,347,2250434,4558,2718542,4457,27973015,4770,30691557,,9522,12741979,28671193
715,All CA Counties,2022-05-06,68450,74208412,38335,44254586,29783,27636988,270,2250704,5471,2718738,5423,27978438,5619,30697176,,12006,12753985,28671193
716,All CA Counties,2022-05-07,29658,74238070,17788,44272374,11774,27648762,89,2250793,2935,2719064,2667,27981105,2993,30700169,,5532,12759517,28671193
717,All CA Counties,2022-05-08,12502,74250572,7387,44279761,5065,27653827,43,2250836,1462,2719511,1047,27982152,1494,30701663,,2535,12762052,28671193
718,All CA Counties,2022-05-09,54802,74305374,29850,44309611,24674,27678501,220,2251056,4065,2719861,3856,27986008,4206,30705869,,9730,12771782,28671193
719,All CA Counties,2022-05-10,55629,74361003,30824,44340435,24523,27703024,222,2251278,4448,2720467,3975,27989983,4581,30710450,,9442,12781224,28671193
720,All CA Counties,2022-05-11,59312,74420315,33098,44373533,25889,27728913,237,2251515,4641,2720970,4289,27994272,4792,30715242,,10100,12791324,28671193
721,All CA Counties,2022-05-12,60113,74480428,33004,44406537,26828,27755741,204,2251719,4339,2721280,4153,27998425,4463,30719705,,9843,12801167,28671193
722,All CA Counties,2022-05-13,69248,74549676,38997,44445534,29960,27785701,212,2251931,5384,2721780,5004,28003429,5504,30725209,,12125,12813292,28671193
723,All CA Counties,2022-05-14,33513,74583189,20037,44465571,13357,27799058,111,2252042,3124,2722308,2665,28006094,3193,30728402,,6226,12819518,28671193
724,All CA Counties,2022-05-15,17109,74600298,10004,44475575,7041,27806099,56,2252098,1692,2722675,1360,28007454,1727,30730129,,3335,12822853,28671193
725,All CA Counties,2022-05-16,54730,74655028,30426,44506001,24002,27830101,210,2252308,4336,2723189,3951,28011405,4465,30734594,,9654,12832507,28671193
726,All CA Counties,2022-05-17,55140,74710168,30592,44536593,24266,27854367,209,2252517,4497,2723821,3990,28015395,4622,30739216,,9957,12842464,28671193
727,All CA Counties,2022-05-18,56823,74766991,31737,44568330,24764,27879131,247,2252764,4696,2724519,4144,28019539,4842,30744058,,10272,12852736,28671193
728,All CA Counties,2022-05-19,60104,74827095,32777,44601107,27036,27906167,195,2252959,4620,2725112,4142,28023681,4735,30748793,,10425,12863161,28671193
729,All CA Counties,2022-05-20,75077,74902172,42713,44643820,32055,27938222,234,2253193,5714,2725719,5241,28028922,5848,30754641,,14822,12877983,28671193
730,All CA Counties,2022-05-21,40126,74942298,25033,44668853,14970,27953192,112,2253305,3464,2726358,2890,28031812,3529,30758170,,9752,12887735,28671193
731,All CA Counties,2022-05-22,22070,74964368,14031,44682884,7962,27961154,69,2253374,1954,2726836,1515,28033327,1993,30760163,,6297,12894032,28671193
732,All CA Counties,2022-05-23,61748,75026116,36001,44718885,25442,27986596,224,2253598,4593,2727414,4168,28037495,4746,30764909,,13030,12907062,28671193
733,All CA Counties,2022-05-24,60838,75086954,35664,44754549,24889,28011485,207,2253805,4416,2728008,3937,28041432,4531,30769440,,13426,12920488,28671193
734,All CA Counties,2022-05-25,60684,75147638,36617,44791166,23770,28035255,216,2254021,4574,2728516,4190,28045622,4698,30774138,,14752,12935240,28671193
735,All CA Counties,2022-05-26,57471,75205109,34012,44825178,23160,28058415,194,2254215,4296,2728902,4024,28049646,4410,30778548,,13685,12948925,28671193
736,All CA Counties,2022-05-27,75091,75280200,46330,44871508,28494,28086909,194,2254409,5420,2729094,5339,28054985,5531,30784079,,20714,12969639,28671193
737,All CA Counties,2022-05-28,35936,75316136,23650,44895158,12183,28099092,99,2254508,2651,2729455,2356,28057341,2717,30786796,,11963,12981602,28671193
738,All CA Counties,2022-05-29,19890,75336026,12740,44907898,7093,28106185,56,2254564,1904,2729990,1408,28058749,1943,30788739,,6012,12987614,28671193
739,All CA Counties,2022-05-30,3532,75339558,2262,44910160,1249,28107434,13,2254577,563,2730228,330,28059079,568,30789307,,1023,12988637,28671193
740,All CA Counties,2022-05-31,62280,75401838,38030,44948190,23943,28131377,223,2254800,4849,2730494,4717,28063796,4983,30794290,,15812,13004449,28671193
741,All CA Counties,2022-06-01,57200,75459038,34561,44982751,22364,28153741,182,2254982,4522,2731314,3816,28067612,4636,30798926,,14923,13019372,28671193
742,All CA Counties,2022-06-02,54483,75513521,33191,45015942,21022,28174763,176,2255158,4119,2731717,3826,28071438,4229,30803155,,14499,13033871,28671193
743,All CA Counties,2022-06-03,66553,75580074,41199,45057141,25063,28199826,222,2255380,4711,2731896,4663,28076101,4842,30807997,,18727,13052598,28671193
744,All CA Counties,2022-06-04,34442,75614516,23152,45080293,11193,28211019,85,2255465,2977,2732456,2472,28078573,3032,30811029,,11872,13064470,28671193
745,All CA Counties,2022-06-05,16349,75630865,10877,45091170,5418,28216437,50,2255515,1737,2732938,1291,28079864,1773,30812802,,5127,13069597,28671193
746,All CA Counties,2022-06-06,50515,75681380,31383,45122553,18882,28235319,187,2255702,4246,2733467,3831,28083695,4360,30817162,,14126,13083723,28671193
747,All CA Counties,2022-06-07,48476,75729856,30276,45152829,17987,28253306,148,2255850,4329,2734286,3612,28087307,4431,30821593,,12976,13096699,28671193
748,All CA Counties,2022-06-08,48553,75778409,30490,45183319,17846,28271152,149,2255999,4242,2734952,3676,28090983,4342,30825935,,13701,13110400,28671193
749,All CA Counties,2022-06-09,46222,75824631,28709,45212028,17299,28288451,163,2256162,4032,2735609,3481,28094464,4138,30830073,,13285,13123685,28671193
750,All CA Counties,2022-06-10,56176,75880807,35897,45247925,20065,28308516,170,2256332,4874,2736223,4379,28098843,4993,30835066,,17129,13140814,28671193
751,All CA Counties,2022-06-11,26016,75906823,17654,45265579,8272,28316788,86,2256418,2539,2736575,2245,28101088,2597,30837663,,8677,13149491,28671193
752,All CA Counties,2022-06-12,12988,75919811,8701,45274280,4227,28321015,51,2256469,1524,2736959,1181,28102269,1565,30839228,,4257,13153748,28671193
753,All CA Counties,2022-06-13,42006,75961817,26642,45300922,15137,28336152,143,2256612,3997,2737601,3455,28105724,4097,30843325,,12519,13166267,28671193
754,All CA Counties,2022-06-14,41434,76003251,26188,45327110,14996,28351148,171,2256783,4095,2738507,3302,28109026,4208,30847533,,11807,13178074,28671193
755,All CA Counties,2022-06-15,43081,76046332,27211,45354321,15617,28366765,162,2256945,4051,2739077,3585,28112611,4155,30851688,,12355,13190429,28671193
756,All CA Counties,2022-06-16,41645,76087977,26473,45380794,14915,28381680,186,2257131,4073,2739867,3401,28116012,4191,30855879,,12340,13202769,28671193
757,All CA Counties,2022-06-17,49677,76137654,31693,45412487,17734,28399414,185,2257316,4559,2740422,4118,28120130,4673,30860552,,15136,13217905,28671193
758,All CA Counties,2022-06-18,21914,76159568,14482,45426969,7360,28406774,63,2257379,2507,2740976,1992,28122122,2546,30863098,,6937,13224842,28671193
759,All CA Counties,2022-06-19,9486,76169054,6413,45433382,3043,28409817,26,2257405,1183,2741249,930,28123052,1203,30864301,,3066,13227908,28671193
760,All CA Counties,2022-06-20,37110,76206164,23142,45456524,13721,28423538,150,2257555,3914,2742769,2495,28125547,4015,30868316,,11188,13239096,28671193
761,All CA Counties,2022-06-21,39086,76245250,23457,45479981,14884,28438422,144,2257699,6062,2745764,3169,28128716,6164,30874480,,10665,13249761,28671193
762,All CA Counties,2022-06-22,41950,76287200,24389,45504370,15619,28454041,147,2257846,8193,2750724,3324,28132040,8284,30882764,,10951,13260712,28671193
763,All CA Counties,2022-06-23,42870,76330070,23877,45528247,16447,28470488,147,2257993,9668,2757284,3207,28135247,9767,30892531,,11379,13272091,28671193
764,All CA Counties,2022-06-24,52059,76382129,28159,45556406,19887,28490375,170,2258163,12759,2766243,3913,28139160,12872,30905403,,13424,13285515,28671193
765,All CA Counties,2022-06-25,27978,76410107,14635,45571041,10333,28500708,78,2258241,9502,2773746,2045,28141205,9548,30914951,,6887,13292402,28671193
766,All CA Counties,2022-06-26,12104,76422211,7389,45578430,3800,28504508,32,2258273,2939,2775596,1106,28142311,2956,30917907,,3438,13295840,28671193
767,All CA Counties,2022-06-27,39678,76461889,22510,45600940,14255,28518763,160,2258433,9284,2781858,3130,28145441,9392,30927299,,10355,13306195,28671193
768,All CA Counties,2022-06-28,40080,76501969,21830,45622770,15160,28533923,139,2258572,10101,2788803,3238,28148679,10183,30937482,,10012,13316207,28671193
769,All CA Counties,2022-06-29,40519,76542488,22568,45645338,15146,28549069,135,2258707,9986,2795720,3159,28151838,10076,30947558,,10352,13326559,28671193
770,All CA Counties,2022-06-30,41233,76583721,22098,45667436,15801,28564870,143,2258850,10587,2803106,3294,28155132,10680,30958238,,10311,13336870,28671193
771,All CA Counties,2022-07-01,47282,76631003,25697,45693133,18027,28582897,157,2259007,11509,2811315,3403,28158535,11612,30969850,,11954,13348824,28671193
772,All CA Counties,2022-07-02,19599,76650602,11268,45704401,7073,28589970,66,2259073,4627,2814398,1586,28160121,4669,30974519,,5184,13354008,28671193
773,All CA Counties,2022-07-03,9294,76659896,5991,45710392,2971,28592941,26,2259099,1667,2815199,889,28161010,1690,30976209,,2700,13356708,28671193
774,All CA Counties,2022-07-04,1587,76661483,1004,45711396,485,28593426,6,2259105,526,2815579,149,28161159,529,30976738,,394,13357102,28671193
775,All CA Counties,2022-07-05,40695,76702178,23259,45734655,14911,28608337,165,2259270,8838,2820733,3789,28164948,8943,30985681,,10274,13367376,28671193
776,All CA Counties,2022-07-06,40795,76742973,23562,45758217,14796,28623133,144,2259414,8620,2826058,3396,28168344,8721,30994402,,10485,13377861,28671193
777,All CA Counties,2022-07-07,41281,76784254,23225,45781442,15463,28638596,131,2259545,8675,2831593,3224,28171568,8759,31003161,,10300,13388161,28671193
778,All CA Counties,2022-07-08,51233,76835487,28699,45810141,19323,28657919,150,2259695,10752,2838535,3909,28175477,10851,31014012,,12637,13400798,28671193
779,All CA Counties,2022-07-09,25564,76861051,14540,45824681,9657,28667576,82,2259777,6058,2842689,1956,28177433,6110,31020122,,6317,13407115,28671193
780,All CA Counties,2022-07-10,11771,76872822,7288,45831969,4103,28671679,38,2259815,2244,2843937,1021,28178454,2269,31022391,,3171,13410286,28671193
781,All CA Counties,2022-07-11,40274,76913096,23579,45855548,14981,28686660,139,2259954,7276,2848043,3268,28181722,7374,31029765,,10263,13420549,28671193
782,All CA Counties,2022-07-12,43240,76956336,24350,45879898,16218,28702878,150,2260104,8283,2853131,3298,28185020,8386,31038151,,10460,13431009,28671193
783,All CA Counties,2022-07-13,49020,77005356,27310,45907208,18612,28721490,144,2260248,8275,2858010,3492,28188512,8371,31046522,,11400,13442409,28671193
784,All CA Counties,2022-07-14,50983,77056339,27803,45935011,19619,28741109,136,2260384,8379,2862928,3543,28192055,8461,31054983,,11300,13453709,28671193
785,All CA Counties,2022-07-15,63033,77119372,34037,45969048,23611,28764720,184,2260568,10608,2869379,4274,28196329,10725,31065708,,13955,13467664,28671193
786,All CA Counties,2022-07-16,31000,77150372,17041,45986089,10724,28775444,84,2260652,5136,2872400,2160,28198489,5181,31070889,,7033,13474697,28671193
787,All CA Counties,2022-07-17,15305,77165677,9132,45995221,5230,28780674,42,2260694,2127,2873408,1152,28199641,2160,31073049,,3609,13478306,28671193
788,All CA Counties,2022-07-18,48854,77214531,27480,46022701,17898,28798572,207,2260901,7379,2877298,3612,28203253,7502,31080551,,11007,13489313,28671193
789,All CA Counties,2022-07-19,49429,77263960,26468,46049169,18575,28817147,172,2261073,8354,2881476,4287,28207540,8465,31089016,,11231,13500544,28671193
790,All CA Counties,2022-07-20,47310,77311270,25779,46074948,17584,28834731,139,2261212,7910,2884688,4789,28212329,8001,31097017,,10981,13511525,28671193
791,All CA Counties,2022-07-21,49162,77360432,25709,46100657,19196,28853927,143,2261355,8012,2887571,5224,28217553,8107,31105124,,10574,13522099,28671193
792,All CA Counties,2022-07-22,60349,77420781,31468,46132125,23865,28877792,135,2261490,9252,2889871,7029,28224582,9329,31114453,,13167,13535266,28671193
793,All CA Counties,2022-07-23,28836,77449617,14901,46147026,11842,28889634,79,2261569,4748,2890016,4654,28229236,4799,31119252,,6238,13541504,28671193
794,All CA Counties,2022-07-24,12087,77461704,7410,46154436,4160,28893794,36,2261605,1896,2890550,1385,28230621,1919,31121171,,3014,13544518,28671193
795,All CA Counties,2022-07-25,42270,77503974,23557,46177993,16376,28910170,167,2261772,6990,2893291,4358,28234979,7099,31128270,,10428,13554946,28671193
796,All CA Counties,2022-07-26,43626,77547600,23484,46201477,16533,28926703,139,2261911,7547,2895401,5533,28240512,7643,31135913,,10507,13565453,28671193
797,All CA Counties,2022-07-27,42419,77590019,22768,46224245,16130,28942833,153,2262064,7514,2897346,5677,28246189,7622,31143535,,10323,13575776,28671193
798,All CA Counties,2022-07-28,41494,77631513,22147,46246392,15712,28958545,149,2262213,7344,2898820,5968,28252157,7442,31150977,,10127,13585903,28671193
799,All CA Counties,2022-07-29,49176,77680689,26287,46272679,18355,28976900,157,2262370,8346,2900062,7209,28259366,8451,31159428,,11832,13597735,28671193
800,All CA Counties,2022-07-30,21528,77702217,12327,46285006,7432,28984332,58,2262428,3889,2900647,3340,28262706,3925,31163353,,5364,13603099,28671193
801,All CA Counties,2022-07-31,8784,77711001,5737,46290743,2583,28986915,24,2262452,1617,2901294,988,28263694,1635,31164988,,2533,13605632,28671193
802,All CA Counties,2022-08-01,33840,77744841,20036,46310779,11189,28998104,146,2262598,6296,2904082,3613,28267307,6401,31171389,,9361,13614993,28671193
803,All CA Counties,2022-08-02,35485,77780326,19927,46330706,12092,29010196,117,2262715,6767,2905967,4951,28272258,6836,31178225,,9398,13624391,28671193
804,All CA Counties,2022-08-03,36083,77816409,20832,46351538,12008,29022204,141,2262856,6913,2908242,4725,28276983,7000,31185225,,9927,13634318,28671193
805,All CA Counties,2022-08-04,35005,77851414,19878,46371416,11888,29034092,106,2262962,6797,2910111,5000,28281983,6869,31192094,,9473,13643791,28671193
806,All CA Counties,2022-08-05,41372,77892786,23050,46394466,14216,29048308,136,2263098,7699,2911715,6187,28288170,7791,31199885,,11116,13654907,28671193
807,All CA Counties,2022-08-06,19058,77911844,11057,46405523,6370,29054678,61,2263159,3679,2912072,3369,28291539,3726,31203611,,5001,13659908,28671193
808,All CA Counties,2022-08-07,8211,77920055,5307,46410830,2434,29057112,27,2263186,1622,2912479,1232,28292771,1639,31205250,,2470,13662378,28671193
809,All CA Counties,2022-08-08,31575,77951630,18747,46429577,10328,29067440,132,2263318,5675,2913650,4600,28297371,5771,31211021,,9071,13671449,28671193
810,All CA Counties,2022-08-09,32098,77983728,18155,46447732,10600,29078040,127,2263445,6249,2915303,4673,28302044,6326,31217347,,8836,13680285,28671193
811,All CA Counties,2022-08-10,23357,78007085,12862,46460594,7725,29085765,110,2263555,4572,2916385,3557,28305601,4639,31221986,,6288,13686573,28671193
812,All CA Counties,2022-08-11,23975,78031060,12901,46473495,8348,29094113,101,2263656,5106,2917854,3702,28309303,5171,31227157,,6297,13692870,28671193
813,All CA Counties,2022-08-12,37434,78068494,20836,46494331,12860,29106973,127,2263783,7221,2918956,6210,28315513,7312,31234469,,10015,13702885,28671193
814,All CA Counties,2022-08-13,16368,78084862,9521,46503852,5339,29112312,60,2263843,3362,2919466,2892,28318405,3402,31237871,,4384,13707269,28671193
815,All CA Counties,2022-08-14,7043,78091905,4723,46508575,1903,29114215,27,2263870,1418,2919952,953,28319358,1439,31239310,,2152,13709421,28671193
816,All CA Counties,2022-08-15,26722,78118627,15500,46524075,9036,29123251,123,2263993,5105,2921171,3974,28323332,5193,31244503,,7294,13716715,28671193
817,All CA Counties,2022-08-16,26063,78144690,14457,46538532,8813,29132064,121,2264114,4983,2922216,4023,28327355,5068,31249571,,6819,13723534,28671193
818,All CA Counties,2022-08-17,26281,78170971,14662,46553194,9096,29141160,94,2264208,5214,2923530,3967,28331322,5281,31254852,,6901,13730435,28671193
819,All CA Counties,2022-08-18,25404,78196375,13802,46566996,9031,29150191,99,2264307,5203,2924694,4101,28335423,5265,31260117,,6392,13736827,28671193
820,All CA Counties,2022-08-19,31338,78227713,17119,46584115,10836,29161027,107,2264414,6147,2925530,5401,28340824,6237,31266354,,7912,13744739,28671193
821,All CA Counties,2022-08-20,12687,78240400,7461,46591576,4210,29165237,49,2264463,2574,2925865,2269,28343093,2604,31268958,,3384,13748123,28671193
822,All CA Counties,2022-08-21,5427,78245827,3568,46595144,1607,29166844,15,2264478,1184,2926239,822,28343915,1196,31270154,,1611,13749734,28671193
823,All CA Counties,2022-08-22,21875,78267702,12289,46607433,7684,29174528,105,2264583,4162,2927018,3463,28347378,4242,31274396,,5752,13755486,28671193
824,All CA Counties,2022-08-23,22312,78290014,12062,46619495,7904,29182432,91,2264674,4444,2927900,3623,28351001,4505,31278901,,5644,13761130,28671193
825,All CA Counties,2022-08-24,22741,78312755,12475,46631970,7840,29190272,113,2264787,4552,2928862,3665,28354666,4627,31283528,,5912,13767042,28671193
826,All CA Counties,2022-08-25,21432,78334187,11526,46643496,7716,29197988,114,2264901,4551,2929773,3722,28358388,4633,31288161,,5411,13772453,28671193
827,All CA Counties,2022-08-26,26568,78360755,14347,46657843,9145,29207133,109,2265010,5454,2930410,4887,28363275,5524,31293685,,6644,13779097,28671193
828,All CA Counties,2022-08-27,11915,78372670,7035,46664878,3805,29210938,47,2265057,2552,2930643,2351,28365626,2584,31296269,,3103,13782200,28671193
829,All CA Counties,2022-08-28,5279,78377949,3451,46668329,1552,29212490,18,2265075,1163,2930914,907,28366533,1178,31297447,,1530,13783730,28671193
830,All CA Counties,2022-08-29,18526,78396475,10435,46678764,6384,29218874,102,2265177,3588,2931458,3110,28369643,3654,31301101,,4879,13788609,28671193
831,All CA Counties,2022-08-30,19298,78415773,10347,46689111,6910,29225784,81,2265258,3921,2932128,3315,28372958,3985,31305086,,4835,13793444,28671193
832,All CA Counties,2022-08-31,16106,78431879,8636,46697747,5416,29231200,96,2265354,3829,2933187,2834,28375792,3893,31308979,,3904,13797348,28671193
833,All CA Counties,2022-09-01,10531,78442410,5118,46702865,3529,29234729,67,2265421,3137,2933803,2571,28378363,3187,31312166,,2048,13799396,28671193
834,All CA Counties,2022-09-02,12704,78455114,5780,46708645,4378,29239107,83,2265504,3953,2934227,3587,28381950,4011,31316177,,2495,13801891,28671193
835,All CA Counties,2022-09-03,9266,78464380,2143,46710788,6329,29245436,34,2265538,1539,2934504,1291,28383241,1568,31317745,,5605,13807496,28671193
836,All CA Counties,2022-09-04,6468,78470848,1209,46711997,5055,29250491,19,2265557,741,2934794,469,28383710,759,31318504,,4876,13812372,28671193
837,All CA Counties,2022-09-05,1149,78471997,432,46712429,642,29251133,16,2265573,292,2934957,138,28383848,301,31318805,,605,13812977,28671193
838,All CA Counties,2022-09-06,27124,78499121,7235,46719664,17848,29268981,77,2265650,3379,2935453,2946,28386794,3442,31322247,,17800,13830777,28671193
839,All CA Counties,2022-09-07,46368,78545489,19471,46739135,24814,29293795,69,2265719,4007,2936954,2562,28389356,4063,31326310,,36221,13866998,28671193
840,All CA Counties,2022-09-08,46363,78591852,22998,46762133,21101,29314896,68,2265787,4085,2938389,2708,28392064,4143,31330453,,36011,13903009,28671193
841,All CA Counties,2022-09-09,71858,78663710,36490,46798623,31881,29346777,65,2265852,5391,2939694,4130,28396194,5435,31335888,,57425,13960434,28671193
842,All CA Counties,2022-09-10,38750,78702460,22041,46820664,15017,29361794,40,2265892,2435,2939895,2269,28398463,2470,31338358,,31759,13992193,28671193
843,All CA Counties,2022-09-11,23584,78726044,14281,46834945,8780,29370574,9,2265901,1544,2940764,682,28399145,1551,31339909,,20137,14012330,28671193
844,All CA Counties,2022-09-12,75252,78801296,44987,46879932,28225,29398799,63,2265964,4486,2942706,2597,28401742,4539,31344448,,63786,14076116,28671193
845,All CA Counties,2022-09-13,70588,78871884,45184,46925116,22760,29421559,68,2266032,4577,2944416,2923,28404665,4633,31349081,,58672,14134788,28671193
846,All CA Counties,2022-09-14,79705,78951589,53305,46978421,23850,29445409,63,2266095,5064,2946543,2983,28407648,5110,31354191,,66754,14201542,28671193
847,All CA Counties,2022-09-15,77125,79028714,52734,47031155,21668,29467077,64,2266159,4894,2948204,3286,28410934,4947,31359138,,64362,14265904,28671193
848,All CA Counties,2022-09-16,99567,79128281,65948,47097103,29866,29496943,55,2266214,6127,2949868,4513,28415447,6177,31365315,,82867,14348771,28671193
849,All CA Counties,2022-09-17,43386,79171667,30385,47127488,11500,29508443,25,2266239,2772,2950650,2014,28417461,2796,31368111,,36078,14384849,28671193
850,All CA Counties,2022-09-18,22554,79194221,16600,47144088,5467,29513910,14,2266253,1565,2951612,614,28418075,1576,31369687,,19109,14403958,28671193
851,All CA Counties,2022-09-19,83388,79277609,60724,47204812,20650,29534560,58,2266311,5111,2954286,2487,28420562,5161,31374848,,71161,14475119,28671193
852,All CA Counties,2022-09-20,82060,79359669,58660,47263472,20770,29555330,52,2266363,5257,2956610,2969,28423531,5293,31380141,,69172,14544291,28671193
853,All CA Counties,2022-09-21,90975,79450644,61395,47324867,27069,29582399,72,2266435,5592,2959312,2942,28426473,5644,31385785,,77526,14621817,28671193
854,All CA Counties,2022-09-22,88890,79539534,60770,47385637,25501,29607900,54,2266489,5573,2961823,3108,28429581,5619,31391404,,75090,14696907,28671193
855,All CA Counties,2022-09-23,114829,79654363,74443,47460080,36722,29644622,66,2266555,6737,2964496,4113,28433694,6786,31398190,,97716,14794623,28671193
856,All CA Counties,2022-09-24,49826,79704189,34312,47494392,13972,29658594,22,2266577,2898,2965429,1985,28435679,2918,31401108,,42298,14836921,28671193
857,All CA Counties,2022-09-25,25622,79729811,17566,47511958,7725,29666319,5,2266582,1715,2966617,531,28436210,1719,31402827,,22128,14859049,28671193
858,All CA Counties,2022-09-26,91193,79821004,61755,47573713,27871,29694190,47,2266629,5108,2969864,1898,28438108,5145,31407972,,79643,14938692,28671193
859,All CA Counties,2022-09-27,85698,79906702,59467,47633180,23950,29718140,34,2266663,5122,2972413,2593,28440701,5142,31413114,,73694,15012386,28671193
860,All CA Counties,2022-09-28,92308,79999010,61496,47694676,28647,29746787,38,2266701,5460,2975302,2601,28443302,5490,31418604,,79194,15091580,28671193
861,All CA Counties,2022-09-29,88399,80087409,58463,47753139,27578,29774365,33,2266734,5435,2978069,2696,28445998,5463,31424067,,75709,15167289,28671193
862,All CA Counties,2022-09-30,110190,80197599,69571,47822710,37520,29811885,43,2266777,6185,2980715,3572,28449570,6218,31430285,,94394,15261683,28671193
863,All CA Counties,2022-10-01,47244,80244843,31768,47854478,14439,29826324,21,2266798,2516,2981914,1335,28450905,2534,31432819,,40890,15302573,28671193
864,All CA Counties,2022-10-02,25071,80269914,16619,47871097,8180,29834504,7,2266805,1524,2983018,426,28451331,1530,31434349,,21928,15324501,28671193
865,All CA Counties,2022-10-03,93010,80362924,59177,47930274,32132,29866636,31,2266836,5077,2986256,1863,28453194,5101,31439450,,81502,15406003,28671193
866,All CA Counties,2022-10-04,88432,80451356,55408,47985682,30709,29897345,28,2266864,5009,2988921,2369,28455563,5034,31444484,,76657,15482660,28671193
867,All CA Counties,2022-10-05,97337,80548693,60721,48046403,34487,29931832,33,2266897,5513,2992132,2332,28457895,5543,31450027,,84880,15567540,28671193
868,All CA Counties,2022-10-06,92805,80641498,57702,48104105,33044,29964876,34,2266931,5433,2995359,2230,28460125,5457,31455484,,80419,15647959,28671193
869,All CA Counties,2022-10-07,116044,80757542,70626,48174731,42679,30007555,28,2266959,6324,2998658,3051,28463176,6350,31461834,,101086,15749045,28671193
870,All CA Counties,2022-10-08,51903,80809445,33062,48207793,17762,30025317,11,2266970,2869,3000356,1181,28464357,2879,31464713,,45090,15794135,28671193
871,All CA Counties,2022-10-09,25874,80835319,16505,48224298,9075,30034392,11,2266981,1599,3001519,445,28464802,1608,31466321,,22576,15816711,28671193
872,All CA Counties,2022-10-10,95000,80930319,58600,48282898,34818,30069210,19,2267000,4740,3004510,1767,28466569,4758,31471079,,83820,15900531,28671193
873,All CA Counties,2022-10-11,92030,81022349,57394,48340292,32549,30101759,35,2267035,5336,3007754,2120,28468689,5364,31476443,,79778,15980309,28671193
874,All CA Counties,2022-10-12,98877,81121226,60302,48400594,36686,30138445,32,2267067,5680,3011319,2139,28470828,5704,31482147,,85932,16066241,28671193
875,All CA Counties,2022-10-13,93360,81214586,56996,48457590,34329,30172774,32,2267099,5626,3014843,2128,28472956,5652,31487799,,80458,16146699,28671193
876,All CA Counties,2022-10-14,119568,81334154,71675,48529265,45287,30218061,29,2267128,6556,3018570,2848,28475804,6575,31494374,,103687,16250386,28671193
877,All CA Counties,2022-10-15,49843,81383997,31123,48560388,17754,30235815,22,2267150,2739,3020301,1024,28476828,2755,31497129,,43471,16293857,28671193
878,All CA Counties,2022-10-16,24681,81408678,15105,48575493,9334,30245149,8,2267158,1648,3021597,359,28477187,1655,31498784,,21344,16315201,28671193
879,All CA Counties,2022-10-17,97053,81505731,58224,48633717,37236,30282385,26,2267184,5505,3025432,1690,28478877,5525,31504309,,85126,16400327,28671193
880,All CA Counties,2022-10-18,91026,81596757,54669,48688386,34226,30316611,38,2267222,5422,3028813,2074,28480951,5455,31509764,,78703,16479030,28671193
881,All CA Counties,2022-10-19,96915,81693672,57441,48745827,37594,30354205,34,2267256,5608,3032369,2084,28483035,5640,31515404,,83917,16562947,28671193
882,All CA Counties,2022-10-20,91553,81785225,54948,48800775,34604,30388809,35,2267291,5427,3035732,2095,28485130,5458,31520862,,79365,16642312,28671193
883,All CA Counties,2022-10-21,114344,81899569,68091,48868866,43806,30432615,27,2267318,6169,3039372,2555,28487685,6195,31527057,,99720,16742032,28671193
884,All CA Counties,2022-10-22,50578,81950147,32254,48901120,17426,30450041,9,2267327,2693,3041054,1019,28488704,2701,31529758,,44131,16786163,28671193
885,All CA Counties,2022-10-23,23146,81973293,14570,48915690,8359,30458400,5,2267332,1503,3042219,342,28489046,1507,31531265,,20161,16806324,28671193
886,All CA Counties,2022-10-24,91064,82064357,55243,48970933,34330,30492730,50,2267382,5098,3045761,1600,28490646,5142,31536407,,79692,16886016,28671193
887,All CA Counties,2022-10-25,81052,82145409,49512,49020445,29597,30522327,16,2267398,4790,3048638,1928,28492574,4805,31541212,,70228,16956244,28671193
888,All CA Counties,2022-10-26,51631,82197040,30780,49051225,19240,30541567,16,2267414,3280,3050452,1474,28494048,3288,31544500,,44027,17000271,28671193
